#########################################################################################################################################
#o                #           # # #             #               #       #   #   #                 #               # # # # # #     # #   #
# # ####### # ### # ########### # # ##### # ### # ############# # ####### ### ### ####### ######### ############### # # # # # ##### # ###
# #       # #   #           #           # #   #       # #     #     #   # #   #         #     # #   #               # # #       #       #
# ### # # ################### ### # # ##### ######### # # ########### ### # ### ### # ### # ### # ### ####### ### ### # # ####### #######
#   # # #                       # # #     #         #   #     # # #               # #   # #                 # # #   # #     #       # # #
# ### # # ### ##### # ### # ######### ################### ##### # # ######### ### ### # # # ### ### ### ####### ##### # ##### ####### # #
#   # # #   #     # #   # #         #                                       #   #   # # # #   #   #   #           # #   #               #
# # # # # # # ##### ##### ### ### ####### ##################### ############# # # ######### ### ##### ############# # ### ##### ### # ###
# # # # # # #     #     #   #   #       #                   # #             # # #         #   #     #   # #   # #   # #       #   # #   #
# # # ##### # # # ####### ####### ############### # # ####### ##### ### ##################### # # ### ### # ### # ### # ##### ##### # ###
# # #     # # # #       #       #       #     # # # #             #   # #                   # # # # #   #         #         #     # #   #
# ### ### ### # ####### ##### ########### ##### ##### ### # # # # # ##### ##### ########### ####### ### # ######### ### # # ##### # #####
# #     #   # #       #     #                       #   # # # # # #     # #   #           # # #       #               # # #     # #     #
# ### ############# # # # ##### ####### # # # # # ##### ####### ####### # # ################# # ######### # ### # ##### ### # # ### # # #
# #       #   #   # # # #     #       # # # # # #     #       # #     # #               # # #           # #   # #     #   # # #   # # # #
# ### ##### ### ############### ##### ### ### # ####### ######### ####### ##### ##### # # # # ####### # # ##### ### # ######### ### # ###
# #   #               # #   #       #   #   # #       #             #         #     # #             # # #     #   # #     #   #   # #   #
# # # # ####### ### # # # ############### # ############# # # # ### # ########################### # ##### # # ### ### # # # ### ##### ###
# # #         #   # #               #   # # #           # # # #   #               #             # # #   # # #   #   # # #     #     #   #
##### # ######### ##### # # ##### ### ####### ############# ########### ######### # ######### ##### # ### ######### ##### ###############
#   # #         #     # # #     #                       # # #         #         #           #     #     #         # #   #               #
### # # # # ##### ### ####### ##### ######### ########### ### ####### ##### ####### # ######### # # ##### ########### ######### #########
#     # # #     #   #     # #     #         #       # #             #     #       # #         # # # #   # #       #           #   #   # #
### # # # # ############### ########### ####### ##### # ####### ############# ######### ##### # ##### ##### ### ### ### # ######### ### #
#   # # # #             #           # #   #   #               #             #         #     # #               #       # #               #
### # # # # # # # # ##### ########### ### # ####### # # ### # # ##### # ### ########### ####### # ##### ##### ####### # # # #############
#   # # # # # # # #       # # #         #         # # #   # # #     # # # #           #       # #     #     #       # # # #       # # # #
# # # # ### ### # # # # ### # # ### # ##### ##### # ##### # # # # # # # # ### ### # ### # # # ####### # ##### # ### ##### ######### # # #
# # # #   #   # # # # #           # # # # #     # #     # # # # # # # #     #   # #   # # # #       # #     # #   #     # #             #
# ### # # # # ### # ### # # # ### ### # # ############### # # ### ##### # ##### # ##### ### ### ##### ### ### # # # ####### ####### # ###
# #   # # # #   # #   # # # #   #   #                   # # #   #     # #     # #   #     #   #     #   #   # # # # # #   #       # #   #
# ### # # # ### # # # # # # # # ################# # # # # ### # # # ##### # ### ### ### # # ### # ######### # # # # # # ### ####### # ###
# # # # # #   # # # # # # # # #                 # # # # #   # # # #     # #   #   #   # # #   # #         # # # # #               # #   #
# # # ### ### ####### ### ### ### ##### ##### ####### # # ### ####### # # # # # # ####### # # ############# ### ### # ### ### ### #######
# #     #   #       #   #   #   #     #     #       # # #   #       # # # # # # #       # # #             # # #   # #   #   #   #       #
##### ### # # # ##### # # # # # # # ### # ### # ####### # # # # ### ### # ### # # ####### # # # # # ######### # # # # # # # ########### #
#       # # # #     # # # # # # # #   # #   # #       # # # # #   #   # #   # # #     # # # # # # #       #   # # # # # # #           # #
# # # # # ### # ### ### # # # ### ### # ### # ### # ######### # # ### ### ##### # # # # ### # ### ##### ### ### ##### # # ### ### # ### #
# # # # #   # #   #   # # # # #     # #   # #   # #         # # #   #   #     # # # #     # #   #     #       #     # # #   #   # #   # #
### # # ##### # # # # # # # # # # ### # # # ### # # # # ### ##### # ##### # # ### ### ##### # ##### # # # ######### # ### ### # # # # ###
#   # #     # # # # # # # # # # #   # # # #   # # # # #   #     # #     # # #   #   #     # #     # # # #         # #   #   # # # # #   #
# # # ####### ### ##### # # # ### # # ### # ##### # ######### ############# # # # ##### # ##### ### ### # # ### ############### # # #####
# # #       #   #     # # # #   # # #   # #     # #         #             # # # #     # #     #   #   # # #   #               # # #     #
# ### # ######### ##### ### # # # # ##### ### ### # ### ### ### # ### ##### # # # # ### # # # ##### ### # # ####### ####### ##### ### ###
# #   #         #     #   # # # # #     # # #   # #   #   #   # #   #     # # # # #   # # # #     #   # # #       #       #     #   #   #
# ### # ########### ### # # # ### ##### # # ##### # # # ##### ### # ######### # ### ##### # # ##### ##### # # # # ### ########### #######
# #   #           #   # # # #   #     # #       # # # #     #   # #       # # #   #   #   # #     #     # # # # #   #     #     #       #
# ### # ### ### # # # # # # # # # # ### # ### ######### # # # # ### ### # # ######### ### # # # ##### ##### # ### ######### ### # ##### #
# #   #   #   # # # # # # # # # # #   # #   #         # # # # #   #   # #           # # # # # #     #   #   # #               # #     # #
# ### # ####### ### # ### # # # # ### # # # # ######### ##### # ####### # ### # # ##### # ### # ### # ### # # ### # # ##### # ### ### # #
# #   #       #   # #   # # # # #   # # # # #         #     # #       # #   # # #       #   # #   # #   # # #   # # #     # #   #   # # #
### ### ### # ########### # # # # # ##### # # # # ########### # # ### ### ### # # ####### # ### # # ##### # ### # # # ##### ########### #
#   #     # #           # # # # # #     # # # # #           # # #   #   #   # # #       # #   # # # #   # #   # # # #   #             # #
# # # # ##### # # # # # ### ### ### ##### # ### # ##### # # ### # ####### ### ############# # # ### # ##### ####### # ##### ### ### #####
# # # #     # # # # # #   #   #   #     # # #   #     # # #   # #       #   # #           # # #   #       #       # #   #     #   #     #
### ### # ####### # ### ### # # ### ####### ### # # ### ### ### # ### # # # ### ##### ### ######### ##### # # # ### # ### # # # ### #####
# # #   #       # #   #   # # #   #       #   # # #   #   #   # #   # # # #         #   #         #     # # # #   # #   # # # #   #     #
# # ### # # ####### # # # ### ##### # ### # # # # # ####### ####### ############# # ### ####### ######### # # ##### # # # # # # ### ### #
#   #   # #       # # # # #       # #   # # # # # # #     #       # #           # #   #       #         # # #     # # # # # # #   #   # #
# # # # # # # # # # # # ##### # # # # ####### # # # # ############### ### # ##### ####### # ##### # # ### ######### ### ### # # ##### # #
# # # # # # # # # # # #   #   # # # # #     # # # #                     # #     # #     # #     # # #   #         #   #   # # #     # # #
# # # # ### ##### # ### # # # # ### # # ####### ### ### # # ### ##### # ### ### ### ############# ##### # # ##### # # # # # ### #########
# # # #   #     # #   # # # # #   # #         #   #   # # #   #     # #   #   #   #             # #   # # #     # # # # # # #           #
# ### # ### # # ####### ### # # ### # # # ### # ### ######### # # ######### # # ### ############### ##### ##### # ### ### ##### ### # # #
# #   #   # # #       #   # # #   # # # #   # # #           # # #         # # # #             #         # #   # #   # # #   #     # # # #
# ### # ##### # # ### # # # # # # # # ### # # # # # ### ### ### # # ### ######### ##### # ##### ### ####### ########### ####### ##### ###
# #   #     # # #   # # # # # # # # #   # # # # # #   #   #   # # #   #         #     # #         #             #     #     # #     #   #
# ### ### ### # # # # ######### # # ##### # ### # # # # # # # # ##### # # ####### ##### # ##### ####### # # ##### ##### ##### # # ### # #
# #     # #   # # # #         # # #     # # #   # # # # # # # #     # # #             # #     #       # # # # #               # #   # # #
# # # ### ### # # # # # # # # # # # # # # # ### # ### # # # ##### ### # # # ### # # # # ### # # # # ######### # ##################### ###
# # #   # #   # # # # # # # # # # # # # # # #   # #   # # #     #   # # # #   # # # # #   # # # # #       # #                     #     #
# ### # # # # ### # ####### # # ##### # # ### # ### # # # # ### # # ### # # # # ### ######### ##### # ##### # ####################### # #
# #   # # # #   # #       # # #   #   # #   # # #   # # # #   # # #   # # # # #   #         #     # # #                             # # #
# # # # # ### # ### ######### ####### # # ##### # # # ### # # # ######### # # ### # # # ####### ### # # ##### # ######### ############# #
# # # # #   # #   #         #     # # # #     # # # #   # # # #       #   # #   # # # #   #   # # # #       # #         #             # #
# ### # # # # ##### ####### ####### ### ######### ### # # ##### # # # ### # ####### # ### # ##### ########### ### ##### ##### ######### #
# #   # # # #     #   # # #           #         # #   # #   #   # # #   # #       # #   #                   #   #     #     #         # #
##### # # # # # ### ### # ############# ######### # # # # # # # # # ##### # # # ### # # # ##### # ##### ### ##### # ##### # # # ##### ###
# #   # # # # #   # #                 #         # # # # # # # # # #     # # # #   # # # #     # #     #   #     # #     # # # #     #   #
# ### ##### # # # # # ### # # ### # # # # ### ##### # # # ### # ### # ##### ########### # # # # # ##### # # ##### # ### # ### # ### # ###
#         # # # # #     # # #   # # # # #   #     # # # #   # #   # #     #           # # # # # #     # # #     # #   # #   # #   # #   #
##### ########### # # # # # # ### # # # ### ##### # # # # # ### # # # ##### ########### # # # # # # # # # # # ### # ### # ##### ### # ###
#         #       # # # # # #   # # # #   #     # # # # # #   # # # #     #           # # # # # # # # # # # #   # #   # #     #   # #   #
# # # # ####### ### ### ####### # ##### ### # # ### # ### # # # # # # # # # # ### ### # # # # # ####### # # ####### ### ### # ##### # ###
# # # #       # #     #       # #     # # # # #   # # #   # # # # # # # # # #   #   # # # # # #     #   # #       #   #   # #     # #   #
# # # ### # # # # # # # ####### # ##### # # # # # ### ### # ##### # # ### # # ##### # # ### # # ### ### # # # ####### ### ##### ### # ###
# # #   # # # # # # # #       # #   # #   # # # #   #   # #   #   # #   # # #     # # #   # # #   #   # # # #       #   # #   #   # #   #
# # # # ### # ### # ### # # # ### # # # # ########### ### # ### # ### # ### # # ####### # ############### # # # # # ####### ######### # #
# # # #   # # #   #   # # # # #   #   # #           #   # #   # # #   #   # # #       # #         #   # # # # # # #               # # # #
##### # ### # ##### # ### ##### # # ### ### # # # ### # # # ##### # # # ### ### # ##### # # ####### ### ##### ##### ####### ### ### ### #
#     #   # # #     #   #     # # # #     # # # #   # # # #     # # # #   #   # #     # # #                 #     #       #   #       # #
# # # # # # # ##### ##### # ### # # # # # # # # ### # # # # # # # # # # ##### # # ####### # # ### # ##### # ### # ### # # # # ##### ### #
# # # # # # #   #       # #   # # # # # # # # #   # # # # # # # # # # #     # # #     # # # #   # #     # #   # #   # # # # #     #   # #
# # # ### # # # # # ### # # # ####### # ### ### # # # # # # ### # # # # # # # # # ##### # ### # # # ##### # # # # # ### # ############# #
# # # #   # # # # #   # # # #       # #   #   # # # # # # #   # # # # # # # # # #       #   # # # #   #   # # # # #   # #             # #
### ### # # # # ### # ########### ##### ##### # # ### ##### ########### # ### # ### ##### # # ### # ##### ### # ### ##### ##### #########
#     # # # # # #   #           #     #     # # #   #     #         #   #   # #   #     # # #   # #   # #   # #   #     #     #     #   #
# # # # ### # ##### ### # # # # # # # # ### ### ##### ### # # ######### # ##### ### # # # # # # ### # # # ### # # ### ### ### ####### ###
# # # # #   # #       # # # # # # # # #   #   #     #   # # #       #   #     #   # # # # # # #   # #   #   # # #   #   #   #           #
# # # ##### # # # # # # # # ### # # # # ####### ##### ##### # # ### ### # ### # ### # ### # # # ### ##### # # ### ### ##### # ##### #####
# # # #     # # # # # # # #   # # # # #     # #     #     # # #   #   # #   # #   # #   # # # #   #     # # #   #   #     # #     #     #
### ### # # # # # # # # ### ########### ##### ##### ######### # # # ### # # # ### # # # # # ### # ####### ### # # # # # # # # ### # ### #
#     # # # # # # # # #   #           #           #       #   # # #   # # # #   # # # # # #   # #       # #   # # # # # # # #   # #   # #
### # # ### # ### # # # # # # ######### # # # ##### # ####### # ### # # # ######### # # ### # # ### ### # ### ### ### ##### # # #########
#   # # #   #   # # # # # # #         # # # #     # #     #   #   # # # #         # # #   # # #   #   # #   #   #   #     # # #         #
# # # # # # # ### ##### # ### ############### # ### # ### # # ### # ### ########### # # # # # # # ####### # # ### ### ### # ### # # #####
# # # # # # # #   #     #   #               # #   # #   # # #   # #   #           # # # # # # # #       # # #   #   #   # #   # # #     #
# # # ##### # ####### # # # # # # ### ### # ####### # # # # # # # # ### ### # ##### # ### # # # # # ### # # # # ##### ### # # # # ### ###
# # #   #   # #       # # # # # #   #   # #       # # # # # # # # #   #   # #     # #   # # # # # #   # # # # #     #   # # # # #   # # #
# # ##### # # ##### # # # # # ### # ####### ####### # # # # # # ### # ####### # # # # ##### # ### # # ### # # # # # # # ### # # # # ### #
# #   #   # # #     # # # # #   # #   #   #       # # # # # # #   # #       # # # # #     # #   # # #   # # # # # # # #   # # # # #     #
# # # ### # ######### ##### # ### # ### ##### # ### ### # # # ### # # # # # # # ##### ##### # ##### # ### # # # ### ### # ##### # #######
# # # #   #   #     #     # #   # #         # # # #   # # # #   # # # # # # # #   # #     # #     # #   # # # #   #   # #     # #       #
# ### ### # ### ### # # # # # ##### ############# ### # # ### ####### # # # # ##### # # ### # ####### ### ##### # ##### # # # # # # # ###
# #     # # #   #     # # # #     #                 # # #   #       # # # # #       # #   # #       #   #   #   #     # # # # # # # #   #
# # # # # ######### # # # # # ### # # # # ### # # # ### # ### # # # # ##### ### ####### # ### # # ### # ##### # # # # # ### # # # # # ###
# # # # #   #       # # # # #   # # # # #   # # # #   # #   # # # # #     #   #       # # # # # #   # #     # # # # # #   # # # # # #   #
# ### # # # ### # # # # ##### ##### ### ### # # ### # # # ### # # # # # # # ##### ### ##### # # ### ####### # # # ### # # ### # # #######
#   # # # # #   # # # #   #     # #   #   # # #   # # # #   # # # # # # # #     #   #       # #   #       # # # #   # # #   # # #       #
# # # # # # # # # # # # # ### # # # # ##### ### ########### # # # # # # # # # # # # # ######### ##### # # ############# # # ### # ### ###
# # # # # # # # # # # # # #   #   # #     #   #           # # # # # # # # # # # # # #         #     # # #             # # # #   #   #   #
### # # # # # # # # # # ####### # # # # # ##################### ### ### ### # # # # # # # # ### # ############# ########### ### # # # ###
#   # # # # # # # # # #   #     # # # # #                     #   # #   #   # # # # # # # #   # #   #       # #           #   # # # #   #
# # ### # # # ### ### # ### # # # # # # # # ##### # # ### # ### # # ### ### # ### # # # # # ##### # # ####### ### # ##### ##### # # # # #
# #   # # # # # # #   #   # # # # # # # # #     # # #   # #   # # # #   #   #   # # # # # #     # # #           # #     #   #   # # # # #
### ### # ### # ### # # # # # # # ### # # # # ### # # ####### ##### # # # # ### # # # ####### ### ### ### # # # ######### # ### # ### # #
#     # # #   #     # # # # # # #   # # # # #   # # #       #     # # # # #   # # # #       #   #       # # # #         # # #   #   # # #
### # ######### # # # ### ### # # # # # ### # # # # # ##### ####### # # # # # # ### # # # ### ### # ### # ### ### ### ### # # # # # # # #
#   # #         # # # #     # # # # # # # # # # # # #     #       # # # # # # #   # # # #   # #   #   # #   #   #   #   # # # # # # # # #
# # # ####### # # # # # # # # ### ### ### # # # ### ### # # # ### ### # # # # # # ### # # # ####### # # # # # # # ### ######### # # ### #
# # # #       # # # # # # # #   #   #     # # #   #   # # # #   #   # # # # # # #   # # # #       # # # # # # # # # #       #   # # #   #
### ######### ### ### # # # # # # # ##### # # ### # ######### # ####### ##### # # ### ### # # ##### ####### # ### # # ### ####### ### # #
#   #         #   #   # # # # # # #     # # #   # #     # # # #   #   #     # # #   # # # # #     #       # #   # # #   #       # #   # #
### ########### # ### # # ### # # ### # # ### ### # # ### # ##### # ### # ##### # # ### # ### # ### # ####### ##### # ### # # ##### ### #
#   #           #   # # #   # # #   # # #   # #   # #           #     # #     # # # #       # #   # #       #       #   # # #     # #  x#
#########################################################################################################################################
