#########################################################################################################################################
#o                  # # #     # #       #                   # # #   # # # # # #   #     #     # #         #   # #             # #       #
# # ### # # ##### ### # # ##### # ####### ##### # ########### # # ### # # # # ### # ##### ##### # ##### # # ### # ############# # #######
# #   # # #     # #         #                 # #   #                     #               # # #       # #   #             #   #         #
# # # # # # ##### # ##### ### ### ######### # ####### ############### ##### ### # ### # ### # # ####### ##### ######### ### ### #########
# # # # # #   # #       #       #         # #                   #   #         # #   # #       # #   # # #     #     # #             #   #
# # ### ####### # # # ### ##### ####### ########### ####### ##### ##### ### ############# # ### # ### ### ##### ##### ########### # # ###
# #   #         # # #   #     #       #           #       #         # #   #             # # # # # #     #     #           #     # #     #
# # ### # # ### ####### ####### ####### # # # # ####### # ########### ### ################### # # # ##### ##### ######### # ########### #
# #   # # #   #     # #       #       # # # # #       # #     # #       # #           # # # #         # #         #   # #             # #
### ### ### ####### # ### # # # # # ####### # # # # # ### # ### # ### ##### ########### # # # ####### # # ######### ### ##### ######### #
#     #   #       #     # # # # # #   # # # # # # # #   # #         #   #     # #   #     #         #                       #         # #
### ############### # # # # ### ### # # # ### ####### # # # # ### # ##### ##### # ### ##### ####### ##### ########### # # ##### #########
#                 # # # # #   #   # #       # #     # # # # #   # #                               #     # #         # # #     #   #   # #
### ############# # # ####### # # # ########### ### ### # # # ####### # ### # # ######### # # ### ######### ################### # # ### #
#               # # # #     # # # #               #   # # # #       # #   # # #         # # #   #     # #                     # # #   # #
### # # # ### # ##### # ##### # ### ### # ################# ##### # ##### ####### ######### # ### # # # # ### ##################### ### #
#   # # #   # #     #       # #   #   # #               # #     # #     #       #         # #   # # #       #   # #     # # #         # #
# # # # # ### # ####### ### ########### # ############### ##### ### # ##### ### ############# ####### # # # ##### # ##### # # ######### #
# # # # #   # #       #   #           # #       #             # # # #     #   #         #   #       # # # #                             #
# # # # # ### # ############### # # # # # # # ### ##### ######### ### ### # ############# ##### # ### # # # ####### ### ### ### # # #####
# # # # #   # #               # # # # # # # # #       #             #   # #                   # #   # # # #       #   #   #   # # #     #
# # # ### ####### ### # ########### ##### ##### ################### ##### # # # ################# ##### # # ##### # ##### # ######### ###
# # #   #       #   # #           #   # #     # #                 #     # # # #                 #     # # #     # #     # #         #   #
# # # ##### ######### # # ##### ####### ####### # ######### # ### ### ### # # # # ### # # ##### ##### # # # # ### # # # ### ####### #####
# # #     #         # # #     # #           # #           # #   #   #   # # # # #   # # #     #     # # # # #   # # # #   #     # #     #
# # # ### # # # ### # ### ####### ######### # # ### ### ### # # # # # # # ### # ##### # # # ##### # # # ### ### ### ####### # ### #######
# # #   # # # #   # #   # #     # #       #       #   #   # # # # # # # # #   #     # # # #     # # # # # #   #   #       # #           #
# # # # ### # ### ### ### # ##### # ### ### ### # ### ####### # ### ##### ##### # # # # # # ########### # # ### # # # ##### # # # ### # #
# # # #   # #   #   #   #             #   #   # #   #       # #   #     #     # # # # # # #           # # #   # # # #     # # # #   # # #
# # # ####### ##### # ### # # ##### # ##### ##### ############# ##### ################# ##### ########### ######### ######### # # # # # #
# # #       #     # #   # # #     # #     #     #           # #     #                 #     #                     #         # # # # # # #
# ### ####### # # ##### # # # # ########### ### # ##### ##### ### ####### ####### # # ##### # ### ### # ### # ############### # ### # ###
# #         # # #     # # # # #         #     # #     #         #       #       # # # #   # #   #   # #   # #               # #   # #   #
# ### ####### # # ### # # # # # ##### ########### # ####### ##### # ### # ######### ### ##### ### ### # # ####### ########### ### ### # #
# # #       # # #   # # # # # #     #           # #       #     # #   # #         #         #   #   # # #       #           #   #   # # #
### # ####### ### ######### # # ##### # # ##### # ####### # # ### ### ######### # # # # # ######### ### ### # # # # # ### ### # ##### ###
# #         #   #         # # #     # # #     # #       # # #   #   #         # # # # # #         #   #   # # # # # #   #   # #     # # #
# # # ### # # # ####### # # # # # ####### # # # # ####### ### # # # # ### ### # # # # # ####### ##### # # # # ### ########### ### # ### #
#   #   # # # #       # # # # # #       # # # # #       #   # # # # #   #   # # # # # #       # #   # # # # # # # # # #     #   # #   # #
# # # # # # # # # # # ### # # # ### ##### # # ### # # # ### ### # # # ########### ### # # # # # # ### # # # # # ### # # ### ##### ### # #
# # # # # # # # # # #   # # # #   #   # # # #   # # # #   #   # # # #           #   # # # # # # #   # # # # #             #     #   #   #
### # # # # ### # # # ##### # # # # ### # ####### ### ### ##### ### # ######### ########### ##### ######### # ### ### # # ###############
#   # # # # #   # # #     # # # # #   # #       #   #   #     #   # #         #       #   #             # # #   #   # # #         # # # #
# # # # # # # # # ####### # # ### # ### # ### ### # ############### ### # # # # # # ### ##### ####### # # ####### ### ######### # # # # #
# # # # # # # # #       # # #   # #     #   #   # #               #   # # # # # # #         #       # #         #   #         # #       #
# # ####### ### # # # # ### # # # ### ### # ### # # # ### ### ### ##### ####### ##### # ### ####### ########### ### # ############### ###
# # #     #   # # # # #   # # # #   #   # #   # # # #   #   #   #     #     # #     # #   #       #           #   # #               #   #
# # # ####### # # # ### ##### ##### # ### # # ############### ### # ##### ### ####### ########### ####### # ### # # # # ##### ######### #
# #         # # # #   #     #     # #   # # #               # # # #     # #         #           #       # #   # # # # #     #         # #
# # ##### ##### # # # ### # # # ### # ### ### ### ### # # ##### ########### ### ### ########### ##### ##### ### # ### ##### # ##### # ###
# #     #     # # # #   # # # #   # # #     #   #   # # #   # #               #   #           #     #     #   # #   #     # #     # #   #
### ### # ##### # # ### ##### ### ####### # # ##### ### ### # # ################# # ### ### ######### # ##### # ### ##### ##### # # # # #
#     # #   #   # #   #     #   #     #   # #     #   #   #                     # #   #   # #       # #     # #   #     #     # # # # # #
# # # # # # # # # # ### # ### ### # # # # # # # # # ####################### # # ### # ####### ########### # ############### ### # # # ###
# # # # # # # # # #   # #   #   # # # # # # # # # #                       # # #   # #                   # #               # # # # # #   #
# # ### # # # # ### # # # # # ##### # # # # # ### # ### # ##### # # ### ### ####### ### # # # # # ### ### ######### ##### # # ####### ###
# #   # # # # #   # # # # # #     # # # # # #   # #   # #     # # #   #   #       #   # # # # # #   # # #     #   #     # #         # # #
# # # ### ### # # # # # # ### # ####### # # # ### # # ####### ### ### ########### ########### ######### ####### ##### ####### ##### ### #
# # #   #   # # # # # # # # # #       # # # #   # # #       #   #   #           #   # #     #                       #       #     # # # #
# # ### ##### # ### # ##### # # ####### # # # # # # # # ### # ##### ################# # ########### ####### ### ### ##### ####### ### # #
# #   #   #   #   # #       # #       # # # # # # # # #   # #     #                       # # # # #       #   #   #     #   #   # #   # #
# # # ####### # # ##### ##### # # ### # ### # # ##### # # ### # ##### ### ### ### # # ### # # # # ######### ####### ######### ##### ### #
# # #     #   # #     #     # # #   # # #   # #   #   # #   # #     #   #   #   # # #   #                 #       #       #     #       #
# # # ### ### # ####### # # ##### ####### # # ### # # # # # # ### # # # # ####### # ### ### # ##### ### ##### # # ######### ##### ##### #
# # #   #   # #     #   # #     #       # # #   # # # # # # #   # # # # #       # #   #   # #     #   #     # # #                     # #
# ### # # ### # # ### # # # # ######### # # ##### # # # # # # ### # # ##### # # ### # # # ### # ####### # # ##### # # # # # ### #########
# #   # #   # # #   # # # # #         # # #     # # # # # # #   # # #     # # #   # # # # #   #       # # #     # # # # # #   #         #
### # # # # # # # ##### ### # # # ##### # # # ##### # # # ### ### # # # ####### ### # # # ### ####### # # ### ##### # ##### ### ### # ###
#   # # # # # # #     #   # # # #     # # # #     # # # #   #   # # # #       #   # # # #   #       # # #   #     # #     #   #   # #   #
# # # # # ##### ### ### # # # # # ##### # # ##### ### # # # # ##### ### # # # ##### ### # ### # # # # # # ##### ##### ##### ### # #######
# # # # #     #   # #   # # # # #     # # #     # #   # # # #     #   # # # #     #   # #   # # # # # # #     # #   #     #   # #       #
# # ### # # # # ### # # # # # ####### # # # # ### # # ### # # ##### # # ### # # # # ####### ### # ####### ####### ####### # ### ##### ###
# # #   # # # #   # # # # # #       # # # # #   # # # #   # #     # # #   # # # # #       #   # #       #               # # # #     # # #
### # # ##### # # # ### ##### # # # ############### # ### # # # # # ### ##### ### # # ### ##### # # ### ##### # # ### ####### ##### ### #
#   # #     # # # # #       # # # #               # #   # # # # # #   #     #   # # #   #     # # # # #     # # #   #             #     #
# # ### ######### # ### # ##### # ### ######### # ### ### # # # # # ##### ##### # # # # ########### # ########### ### # # ### ### ### ###
# # #           # #   # #     # #   #         # #   #   # # # # # #     #     # # # # #           #             #   # # #   #   #   #   #
# # ### ##### ### # ### ### # ### # # ############### ####### ##### ### # ####### # ### # ####### # # ############### ############### ###
# # #       #   # # #     # #   # # #       #   #   #       #     #   # #       # #   # #       # # #     #         #         #     #   #
# # # # # # # # # ##### # # ##### ### ####### ### ### ####### # # # ######### # # # # # # ### # ### # # ### ### # # # ### # ### ##### # #
# # # # # # # # #     # # #   #     #           #   #       # # # #         # # # # # # #   # #   # # #       # # # #   # #         # # #
# # ### # # ########### # ####### ### ### ### # # ####### ### # ### ##### # ####### ### # ### # # ######### ##### ### # # # ##### ##### #
# # #   # # #         # #       #   #   #   # #         #   # #   #     # #       #   # #   # # #         #     #   # # # # #   # # # # #
##### # # ### ######### # # # ####### # # # # # # # # # # ### # # ##### # ### ### # ### # # # # # ### ############# ######### ##### # ###
#     # #             # # # #       # # # # # # # # # # #   # # #     # # # #   # #   # # # # # #   #             #     # #             #
# # # ### ### # # ### ### # # # ##### # ### # ### # # # # # # ### # ### # # ### ### ### # ####### ### # # ### ### # ### # # ### ### ### #
# # # #     # # # # #   # # # #     # #   # #   # # # # # # # #   #   # #     #   # #   #       # #   # #   #   # #   #       #   #   # #
######### # ####### ### ### ### # ### # # # # ##### # # # # ### # ### ### # # # # # # # # ####### ### # # # # # ### # ### ### # ### # # #
#         #           #   #   # #   # # # # #     # # # # # # # #   #   # # # # # # # # #       #   # # # # # #   # #   #   # #   # # # #
# # ### # # # ### # # ############# # ####### # ### # # # # # # # ### ### # # # # # # ### ##### # ### # # ### ##### # ####### ##### ### #
# # #   # # #   # # #             # #     #   #   # # # # #   # # #     # # # # # # # #       # #   # # #   #     # #       #   # # #   #
# ### # # # # # ### ####### ############### # # # # # # # # # # # ### # ### # ##### # # # ### ### # # ### ### # ##### ##### # ### ##### #
# #   # # # # #   #       #             # # # # # # # # # # # # #   # #   # #     # # # #   #   # # #   #   # #   #       # #         # #
# ### # # ### # # # # # # ### ##### # ### # # ######### ##### ### ### ### # # ######### # # # ##### ### ######### ### # ####### # # # # #
# #   # #   # # # # # # #   #     # #     # #         #     # #     #   # # #         # # # #     #   #         # #   #       # # # # # #
# # ### # ##### # # # # # ##### # ### # ##### # # ########### ### # # ######### ### ### ##### # # ### ####### ### ### ############### # #
# # #   #     # # # # # #     # #   # #     # # #         #     # # #         #   #   #     # # #   #       #   #   #               # # #
####### # # # # ### ##### ### ### # # # # ##### ############# ### # # # # ##### # # ### ##### ### # # ### # ##### ### # # ### # #########
#       # # # #   #     #   # #   # # # #     #         # # #   # # # # #     # # # #       #   # # #   # #     # #   # #   # #         #
# # ### # # # ##### # # # ####### ##### ##### # # # ##### # ####### # ### # ### # ### # ##### # # # # # # ### # ##### # # # ### #########
# # #   # # #     # # # #       #     #     # # # #   #           # #   # #   # #   # #     # # # # # # #   # #   #   # # #   #         #
######### # # # # # # # ##### ### # ##### ### # # # ### ######### # ##### # ### ####### ### ### # # # # ### ### ##### # # # ######### # #
#         # # # # # # #     #   # #     # #   # # #             # #     # #   #     #     #   # # # # #   #   #     # # # #         # # #
# ### # # # # ### # # # # ### # # ####### ### # # ######### # # ### ### # # # # # # ### # # ### ### ### # # ######### # # # # ###########
# #   # # # #   # # # # #   # # #       #   # # #         # # #   #   # # # # # # #   # # #   # #     # # #       #   # # # #         # #
# # # # # # # ### # # ### ### ##### # # ### # # # # # # # ### # # ######### # # # # # # # ##### # # # ##### # ### ### # # # # ######### #
# # # # # # #   # # #   # # #     # # #   # # # # # # # #   # # #         # # # # # # # #   #   # # #     # #   #   # # # # #         # #
# # # # ### # # # # ####### ####### ### ### # # # # ### # ### # # # # ##### ########### ####### # # # ### # # # ##### # # # # # # ##### #
# # # # #   # # # #               #   #   # # # # #   # #   # # # # #     #         #         # # # #   # # # #     # # # # # # #   #   #
# # # # ### # # # # # # # # # # # # # # ##### # ### ### ### # # ### ##### ### ####### # # ##### ### # # # # # # # ### # # ### # # # # ###
# # # # #   # # # # # # # # # # # # # #     # #   #   #   # # # #       #   #       # # #     # #   # # # # # # #   # # #   # # # #     #
# # # # # # ### # # # # ### # ### # ### ########### ######### # # # # # # ####### ##### # ####### # # # # # # ### ### # ### # # # ### ###
# # # # # # #   # # # #   # #   # # # #           #         # # # # # # #       #     # #       # # # # # # #   #   # #   # # # #   # # #
# # ##### # ### # # # # ### ### ##### # # # # # ### ### ##### # ### # # # # # ### # # # ### ####### # # ####### # # # # # ##### # # # # #
# # #     #   # # # # # #     #       # # # # #   #   #   # # #   # # # # # #   # # # #   #       # # #       # # # # # #     # # # #   #
### # ### # ### # ### # ### # ######### # # ### ####### ### ### ### # ### # # # # # ### ### # ##### # # # ##### # # ### ### ### # # # # #
#   # #   #   # #   # # #   #         # # #   #       #       #   # #   # # # # # #   #   # #     # # # #     # # #   #   #   # # # # # #
### # # ### ### # # # ##### # # ##### ### # # # ############# ##### ### # # ### ### # ### # # # ####### ######### # ### # ### # # #######
#   # # #   #   # # #     # # #     #   # # # #             #     #   # # #   #   # #   # # # # #     # #       # #   # #   # # #       #
### ######### # # # ### # # # ##### ######### # ### # ####### ### ### # # # # # # # # # # # ### # ##### # ####### ##### ### ### # # # # #
#     #       # # #   # # # #     #         # #   # #       #   #   # # # # # # # # # # # # #         #         #     #   # # # # # # # #
# # ### ### # # # # # # ### # ### ### # ####### # ############# ####### # # ####### ##### ##### # # ##### # # # ### # # ##### ### ### # #
# #   # #   # # # # # #   # #   #   # #       # #             #     # # # #       #     #   #   # #     # # # #   # # #     # #     # # #
# # # # # # # ### # ##### # # # ##### ##### ### ### # ##### ### # ### ############# # ####### # # # # # # # # ### # # # # ### # # # # # #
# # # # # # # #   #     # # # #     #     #   #   # #     #   # #   #             # #       # # # # # # # # #   # # # # #     # # # # # #
# # # # ### # ### # # # ### # # # # # ##### ### # # # # # # # # ##### ########### # ##### ##### # # ### # # # # ##### # # # # # # ### # #
# # # # #   # #   # # #   # # # # # #     #   # # # # # # # # # #               # #     #   # # # #   # # # # #     # # # # # # #   # # #
# # # # ### # # # # # ### # ### ##### ##### ### # ##### ######### ### ### ### ##### # # ##### # # # # # # ### # ### # # # # ### # # # # #
# # # # #   # # # # #   # #   #     #     #   # # #   #   #         #   #   #     # # #       # # # # # #   # #   # # # # #   # # # # # #
# # # # ##### # # # ######### # # ##### ########### ### ### ##### # # ############### ########### ########### # # ### # # # # ### ### # #
# # # # #     # # #         # # # # # #       #   #   #         # # #         #   # #           #           # # #   # # # # #   #   # # #
# # # ##### # # # # # ######### ### # ######### ### ########################### ### ######### # # ### # # ### # # # # # ### # ### ### ###
# # # # #   # # # # #       # #       # #                                                   # # #   # # #   # # # # # #   # #   #   # # #
# # # # ### # # # # ######### # ##### # # ######### ##### ### # # ####### # ### # # ##### # ### # ### # # # ### ####### # # ##### # ### #
# # # #     # # # #           #     #             #     #   # # #       # #   # # #     # #   # #   # # # #   #       # # #   #   #    x#
#########################################################################################################################################
