#########################################################################################################################################
#o            # #               #           # #                 #                                 # #   #                             # #
# ### ######### # ####### ### ### ### ####### ### ############### ####### # # # # # ############### # ### ##### ### ##### # # ######### #
#   #                   #   # #     #                                   # # # # # #         #                 #   #     # # #           #
# # # # ##### # ### # ##### ### ############################# ### # ### # ##### ############# ### # ### ### #############################
# # # #     # #   # #     #                                 #   # #   # #     #                 # #   # # # #                 #         #
# # ######### # ### # ########### ######### # # # ####### ####### # # ##### # # # ############# ##### ### ### ### ### # ##### # ##### # #
# #         # #   # #           #     #   # # # #       #       # # #     # # # #             #     # #         #   # #     #       # # #
# # ### # ################### ######### ##### ### # # ### ##### # # # ##### # # # # # ####### # ####### ### ############# # # ##### # ###
# #   # #           #       #               #   # # # # #     # # # #     # # # # # #       # #           #             # # #     # #   #
### ##### # ####### # ####### # # # ### # ### ### # ### # # ####### ##### # # # # # ### ############# ##### ####### # ### ### # #########
#       # #       #         # # # #   # #   #   # #     # #       #     # # # # # #   #             #     #       # #   #   # #         #
### # ### # # ######### ##### # ### ##### ##### # # # # # ######### # # ######### ### ######### ####### # # ##### # ##### ####### # #####
#   #   # # #         #     # #   #   #       # # # # # #         # # #         #   #         #       # # #     # # #   # #     # #     #
### # ##### ### # # ### ### # # ### # ### # # ##### ##### ### ### ### # # ############# ### # ####### ############# # ##### ########### #
#   #     #   # # # #     # # #   # # #   # #     #     #   #   #   # # #             #   # #       #             #                   # #
# # # ####### ##### ### # ##### ### ### # # ### ##### ### ### ### # # # ##### ######### ####### ### # ### # ############# # # # ### # ###
# # #       #     #   # #     #   #   # # #   #     #   #   #   # # # #     #         #       #   # #   # #             # # # #   # #   #
# # # # # # # # ### ####### # # ######### ### ##### # ### ### # # # # # # # # ######### ### # # ##### ### # ######### # # ########### ###
# # # # # # # #   #       # # #       #     #     # #   #   # # # # # # # # #         #   # # # #   #   # #         # # #           #   #
# ### # ##### ####### # ### ##### # # ### # # # # ### ### # # ##### ####### ### # ####### # # ### ### # # # # ### ### ### # ##### ### # #
# #   #     #       # #   #     # # #   # # # # #   #   # # #     #       #   # #       # # #       # # # # #   #   # # # #     # #   # #
# ### ########### # ##### # # # # # # ### # # # # # # ##### ####### # ####### ####### ##### # # ####### ### ####### # # # ### ### ### ###
# #             # #     # # # # # # #   # # # # # # #     #     #   #       #       #     # # #       #   #       # #   #   #   # #   # #
# ### # # # ######### # # # # ##### # # # ### # ### ############### ### ### # ####### ### # ### ### ### # ### ### ########### # ####### #
# #   # # #         # # # # #     # # # # #   #   #   #         # #   #   # #       #   # #   #   #   # #   #   #       #   # # #       #
# ### # # # ### # # ##### ### # ### ### # # # # ####### ######### # # # # # # # # # ### ############################# ### ####### #######
# #   # # #   # # #     # # # #   #   # # # # #                   # # # # # # # # #   #                             #   #               #
# # # ####### ##### # # # # # # ####### # ### ### ####### ####### # ### ### ##### ######### # ####### ####### # # ####### ####### #######
# # #   #   #     # # # #   # #       # #   #   #       #       # #   #   #     #         # # #     #       # # #     #         #       #
# ### ### ####### # # ### # ### ######### ### ### ##### ##### ### ######### # # ##### ######### ######### ##### ####### ### ### # ### # #
# #             # # #   # #   #         # #     #     #     #   #         # # #     #     #             #     #           #   # #   # # #
##### # # # # ### # # # ##### # ### # # # # # # # ######### # ####### # ##### # # # # ##### ##### # ####### ### # ### # # # # ###########
#     # # # #   # # # #     # #   # # # # # # # #         # #       # #     # # # # # # #       # #       # # # #   # # # # #     #     #
##### # # ### ####################### ### ### # # ### # ######################### # ### # ### ########### ### ### # # ### # ####### #####
#     # #   #                       #   #   # # #   # #                         # # # #     #           #       # # #   # #   #         #
# # # # # ##### ##### ####### # ##### # # ### # # ### # # ### ### ### ########### ### # ##### # # ####### ### ########### ### # #########
# # # # #     #     #       # #     # # #   # # #   # # #   #   #   #       #   #           # # #       #   #           #   #           #
# # # ### # # ### ##### ######### ####### ####### ##### # # # ### # # # ##### ####### # # # ########### # ##### ### ### ### ########### #
# # #   # # #   #     #     #   #       #     #       # # # #   # # # #             # # # #           # #   # #   #   #   # #         # #
# ### # ### ##### ### # # ### ##### # ### ####### ##### # ### # # # # # # # # ####### # ##################### ############### ###########
# #   #   #     #   # # #         # #   #     # #     # #   # # # # # # # # #       # #         # #       #     #     # # #           # #
### # ##### # # # # ### ####### # ### ### ##### # # # # # ####### # # # ##### # # ##### # ####### # ####### ##### ### # # # ### ####### #
#   #     # # # # # # #       # #   #   #     #   # # # #       # # # #     # # # # # # #                       #   #         #     #   #
##### # # # # # # ### # # ##### # # # ### ##### # # ### # # # ### # # # # ### ### # # ### # # # ########### ##### ####### ####### ### ###
#     # # # # # #     # #     # # # #   #     # # #   # # # #   # # # # #   #   #       # # # #           #             #       #       #
### # # ##### # # ##### ################# # ### # # ### # # # ##### ### # # # # # # ### # ### # # ################### ##### # # # ### # #
#   # #     # # #     #     # #         # #   # # #   # # # #     # #   # # # # # #   # # #   # #                   #     # # # #   # # #
# # # ##### # # # ##### ### # # ######### ##### ### # # # ### # ### ### # ### # # # # # # # # ### ### ##### ### # # # ### # ##### # # # #
# # #     # # # #     #   #             #     #   # # # #   # # #     # # #   # # # # # # # #   #   #     #   # # # #   # #     # # # # #
# ### # # ### ### # # # ########### ### ##### # # # # ### # # ### # ### ### # # # # # ### # # ### # # # # ### # # # ### ### ### # # # # #
# #   # #   # #   # # #           #   #     # # # # #   # # #   # #   #   # # # # # #   # # #   # # # # #   # # # #   #   #   # # # # # #
# # # # # # ##### # # ####### ######### # ### ##### # ### # ##### ### # # # # ##### # ### # # # # # # # # ### # # # ######### # #########
# # # # # #   #   # #       #         # #   #     # #   # #     #   # # # # #     # #   # # # # # # # # #   # # # #         # #         #
# ### # # # ### # # # # ############### # ##### ##### # ### # ##### # # # ### ########### ### ############# # # ########### ##### # # ###
#   # # # #   # # # # #     #         # #     #     # #   # #     # # # # #             # #               # # #           #     # # #   #
# ### # # # # # # # ####### # ### ####### ##### ##### ### ### # # ### # ### # # ### ### ### # # ########### ########################### #
#   # # # # # # # #       #     #       #     #     #   #   # # #   # # #   # #   #   #   # # #         # # #                         # #
# ### ### ### ##### ##### # # ### # ### ### ### ##### # # # # ### ##### ### # ##### ### ####### ### ##### ### ### ############# ### # ###
#   #   # # # #         # # #   # #   #   #   #     # # # # #   #   #   #   #     #   #     #     #             #             #   # # # #
# # # ### # ### # # # ##### # # ### ############### ### ### # ######### ### # ####### ####### # # # # ########### # # ### ### # ####### #
# # #   #     # # # #     # # #   #               #   #   # #       #   #   #       #       # # # # #   #       # # #   #   # #         #
# # ### # # # # # # # # # ### ##### ### ############### # # # # ### # ##### # # # ############# # # ##### ### ### # # ### ##### # # # ###
# #   # # # # # # # # # #   #     #   #             # # # # # #   # # #     # # #             # # #         #   # # #   #     # # # #   #
# # # ### ##### # # # ##### ##### ##### # # # # ### # # ##### # # # # ### ### # # ### ### ### # # ### # # # ##### # ### ############### #
# # #   #   # # # # #     #     #     # # # # #   #   #     # # # # # #   #   # #   #   #   # # #   # # # #     # #   #         #     # #
# # # ### # # ### # # ### # # ##### # # ### # ############### # # ### # # ### ### ##### # # # ### # # # # # # ### ### ########### #######
# # #   # # #     # #   # # #     # # #   # #             # # # # #   # # #   #       # # # #   # # # # # # #   #   #                 # #
# # # ##### # # ### # ### # # ####### # ##### # ### ####### ### # ### # # ### # # # # # # ### ### ### # # # # # ############### ####### #
# # #     # # # #   #   # # #       # #     # #   #           # #   # # #   # # # # # # #   #   #   # # # # # #     #         #         #
# ### ### # ### # # ### ##### # ####### # # # # # # # # # # ### ### ### # ### ### # ### ##### # ### ####### # # ### # ####### # #########
#   #   # # #   # #   #     # #       # # # # # # # # # # #   #   #   # #   #   # #   #     # #   #       # # #   #         # #         #
# ##### ####### # # # # ### # # ### ##### ### ##### # ##### # # # ####### ### ##### ##### ### # ### # ### # # # ### ##### # # # # # ### #
#     #   #     # # # #   # # #   #     #   #     # #     # # # #       # #       #     #   # #   # #   # # # #   #     # # # # # #   # #
# # # # # # ### # # # # # # # ### ##### # # # # # ### # # # # # # ### # ##### # # # # ### # # ####### ### ### # # # ####### # # # # # # #
# # # # # # #   # # # # # # #   #     # # # # # #   # # # # # # #   # # # #   # # # #   # # #       #   #   # # # #       # # # # # # # #
# # # # ####### # # # # # # # ### # # ### # ### # ##### # # ##### # # ### # # ### # # # ### ######### # ##### # # # # # ############# # #
# # # #   #     # # # # # # #   # # #   # #   # #   # # # #     # # # #     #   # # # # #           # #     # # # # # #             # # #
# # # ### # # # # # # # # ##### # # ####### ####### # ##### ### # # # # # # # # # ### ### # # ### # ### # ##### # ### ### # # ##### #####
# # #   # # # # # # # # #     # # #       #       #       #   # # # # # # # # # #   #   # # #   # #   # #   #   #   #   # # #     #     #
# ### # # # # # ### ##### ### ############# # ################# ### # # # # # # # # ##### # ##### # ### ##### # # # # ##### # # # # #####
# #   # # # # #   #   #     #             # #                 #   # # # # # # # # #     # #     # #   #     # # # # #     # # # # #     #
# ### # # # ### ### ##### # # ### ####### # # ##### ### # ### ##### ######### # # # ####### ##### # # ##### # # # # # # # ### # # # # ###
# #   # # # #   #     #   # #   #       # # #     #   # #   #     #     #     # # #       #   #   # #     # # # # # # # #   # # # # #   #
# ### ### # ### # # ### # # # ### # # ##### ##### # # ######### ### ####### # # # # ### # # # ### # # # ##### # # ### ### ####### # # # #
#   #   # # #   # #   # # # #   # # #     #   # # # #         #   #   # # # # # # #   # # # #   # # # #     # # #   #   #       # # # # #
# ### ### ##### # # # ### # # # # # # ### # # # ##### ### # ##### ##### # # # # # ##### # # ##### # # # # # ### # ### ### # # ######### #
#   #   # # #   # # # #   # # # # # #   # # #       #   # # # # #         # # # #   # # # #     # # # # # # #   # #     # # #         # #
# # # ### # # # ### ##### # # ### # ######### # # ### ##### # # ##### ### ### # ### # ### # ### # # # ### ### # # ### # ##### ### ### # #
# # # #     # #   #     # # #   # #         # # #   #     #         #   # # # #   #     # #   # # # #   #   # # #   # #     #   #   # # #
# # # # # # # # ### # # # # # # # # ### ### # ### # # # ########### ##### # # # ######### # ### # # # ####### # # # ### # # ### # # ### #
# # # # # # # # # # # # # # # # # #   #   # #   # # # # #         #     #   # #         # #   # # # #       # # # # #   # #   # # #   # #
# ### ### ### # # # # # # # # ### # ### # ####### # ### # ####### # # ### ##### # # # ### # # # # # # # # ### # # # # # # # # # #########
#   #   #   # #   # # # # # #   # #   # #       # #   #         # # #   #     # # # #   # # # # # # # # #   # # # # # # # # # #         #
# # # ### ##### # # # # # # ### ##### # ### # ##### ####### # # # # # ### ######### ##### # ### # # # # # # # # # ### # # # ### #########
# # #   #     # # # # # # #   #     # #   # #     #       # # # # # #   #         #   # # #   # # # # # # # # # #   # # # #   #         #
# # # # # ### # ### # # # # # # ### ### # # ### ### ####### ##### # # # ####### ####### ### # # # # # # # # # # # # # # # ##### # # ### #
# # # # #   # #   # # # # # # #   # #   # #   # # #       #     # # # #       #           # # # # # # # # # # # # # # # #     # # #   # #
# ### ### # ### ### # # # # # # # ##### # # # # # ######### # # # ### ################# ### # # # # ##### ##### # ### # # # ### ### #####
#   #   # #   # #   # # # # # # #     # # # # #           # # # # # #     # #         #   # # # # # #   #     # #   # # # #   #   #     #
# # # # # # # # # # ### # # # # # ####### # ### # # # ##### ####### ### ### # ### # ######### # ### # ### # ### # ### # # # # # ### #####
# # # # # # # # # #   # # # # # #       # #   # # # #     #       #   #         # #     #   # #   #     # # #   #   # # # # # #   #     #
# # ##### ### # ### ### ### # ### # ####### # # # ############# ### ######### ##### ##### ############### # ### ##### ### # # # ### #####
# #     # #   # #     #   # # #   #     # # # # #         #   #             #   # #               #     # #   #     # #   # # #   #     #
# # # ### # # # # # # # ### ##### ####### ### ### ######### ############# ####### ########### ### # ##### ##### # # ####### # # ### # # #
# # #   # # # # # # # #   # #               # #         # #             # # #   #           #   #       #     # # #       # # # # # # # #
# ##### # # # # # # ### # # # # # # # # # # ### # # # ### # ##### # # ##### # ### ##### # ########### ### ##### ### # # # # # # # ### # #
#     # # # # # # #   # # # # # # # # # # #   # # # #           # # # # #     #       # #           # # #     #   # # # # # # #     # # #
# # # # # ##### # # # # # # ##### ### # # # ### # # # # # # ##### ### # # ### # ####### ### ### # ### # ############### # # # # ### ### #
# # # # # #     # # # # # # #       # # # #   # # # # # # #     # #         #         #   #   # #   #               #   # # # #   #   # #
# # # # ####### ### ### # ##### # # # # # # ####### # # # # ####### # # ####### ### ########### # # ##### # # # ####### ### ### # ##### #
# # # #     #   #     # #     # # # # # # #   #     # # # #       # # #       #   #           # # #     # # # #       # # #   # #     # #
# ##### # ##### # # # ### # # # # # ### ##### # # # # # ### ### ### # ##### ######### # # # ##### # # # # # # # ######### # # # # # # # #
#     # #   #   # # #   # # # # # #   #     # # # # # #   #   #   # #     #         # # # #     # # # # # # # #         #   # # # # # # #
# ### # # # # ### # # # # # ### ### # # ### # # # # # # ### # ####### ### # ### # # # # ####### ### # # # # # # ##### ### # # # # # ### #
#   # # # # # #   # # # # # #     # # #   # # # # # # #   # #     #     # #   # # # # #       #   # # # # # # #     # #   # # # # #   # #
# # # ### # ### # # ### ####### ### # # # # # # # # # # ### # ######### ### # # # ############# ### # ### # # # # # # # # # ### ##### ###
# # #   # # #   # #   #     #   # # # # # # # # # # # #   # #         #   # # # #             #   # #   # # # # # # # # # #   #     #   #
### # ### # # # # # # # ##### ### # # ##### # ### # # # ### # ####### # # ### # ##### # # ### ### ### # ##### # ####### # # # # # ### ###
#   #   # # # # # # # #     # #     #     # #   # # # #   # #       # # #   # #     # # # # #   #   # #   # # #       # # # # # #   #   #
# # # ### ##### # # # # # ##### # # # # # # # # # # # # # # # # ### # # # # # # # ### # ### ### # ### # ### ### ### ##### # ### # # # ###
# # #   # # #   # # # # #   #   # # # # # # # # # # # # # # # #   # # # # # # # #   # #       # #   # #       #   #     # #   # # # #   #
# # # ##### # ### # # # # ##### # # ##### # # # # # # # ### # # ### # # # ### ### # ##### # ####### ### ### # # ######### # # ##### # ###
# # #       # #   # # # #   #   # #     # # # # # # # #   # # #   # # # #   #   # #     # #       #   #   # # #         # # #     # #   #
### # # ### ### # ### # # ##### # # # # # # # ### # ### ### # # # ##### # # # # # ### # # # ### # ##### # ### # ########### ##### # # ###
#   # #   #   # #   # # #     # # # # # # # # #   # #   #   # # #     # # # # # #   # # # #   # #   # # #   # #         #       # # #   #
##### # ### ### # ### # ### # # # # ### ##### # ### ### # ### # ######### # # # ####### # # # # ### # # ##### ########### # # ### ### # #
#     #   # #   # # # #   # # # # #   #     # # #   #   # #   #         # # # #       # # # # #   #   #     #           # # #   # #   # #
# # # ##### ### ### ### ### ##### # ############### # # ##### ### ##### ### # ##### # ### ### ############################# # ##### # # #
# # #     # #   #         #   #   #             #   # #     #   #     #   # #     # # # #   #                       #     # #     # # # #
# ### # ### # # # ### # # # # # # # # ##### ########### # ### ### ### ### ########### # ### # # ### # ########### # # ### ### # ##### # #
# #   #   # # # # #   # # # # # # # #     #     #       #   # #     #   # #   # # # #     # # #   # #           # #     # # # # # # # # #
# ### # # ##### ##### # # # ### # # # ################### # # # # ### ##### ### # # ####### # ################# ### # # ### # ### # # # #
# #   # #   #   #     # # #   # # # #         # #       # # # # #   #                     # #                 # # # # #   # # # #   # # #
##### # ########### # ##### # # ### # ######### ##### # # ##### # # ### ##### ### # ##### ### # ######### # ##### ### ##### ### # ### # #
#     #   #         #     # # # #   #             #   #       # # #   #     #   # #     #   # #         # #         #               # #x#
#########################################################################################################################################
