#########################################################################################################################################
#o              #                 #                             #         # #         # #   #                 # #             #         #
# # # ####### ### ##### ########### ##### ######### # ######### # ### ##### # ######### # ### ### ############# # ####### ##### ### ### #
# # #       #         #                 #         # #     #   #     #     # # # # # #   #       #           #           #         #   # #
# # # ####### ########### # ##### ##### ################# # ############### # # # # # ### ### # # # # # # ### ################### # #####
# # #     #             # #     #     #             # # #       #     #   #                 # # # # # # #   #   #               # #     #
### # ### ####### ##### ##### ### ####### # # # ##### # ######### ##### ### ################### ### # ####### ### ### # # ### ##### #####
#   #   #       #     #     #   #       # # # #                       # #   #       #     #   #   # #     # #       # # #   #     #     #
### # # ######### ### # # ####### ##### # ### ############### ######### # ### ####### ##### ### # # ####### # ### # # # # # ### # # # # #
#   # #         #   # # #       #     # #   #               #     #   # #                     # # #     #       # # # # # #   # # # # # #
# # ### # # ##### ### # # # # # ######### # ### # ### ######### ### ### # ############# ##### ########### ### ### ### # ### ### ### # ###
# #   # # #     #   # # # # # #         # #   # #   #         #                       #     #     #     #   #   #   # #   #   #   # #   #
# # # ### # # ### ####### # ### # ### # ### # ### # # # # # ################# # ##### # ########### ##### ################# ### # ### ###
# # #   # # #   #       # #   # #   # #   # #   # # # # # #           #     # #     # #           #                       #   # #   #   #
# # # # # # ### ### ### # # ### # # # # # ### ### # # # ### # # ####### ######### ### # # ######### ##################### ### ##### #####
# # # # # #   #   #   # # #   # # # # # #   #   # # # #   # # #                 #   # # #                               #   #     # # # #
# # # # # # ##################### # ### ### # # # # # ### ######### ##### # # # # ### ### ####### ##### # ########### ######### ##### # #
# # # # # #                     # #   #   # # # # # #   #         #     # # # # #   #   #   #   #     # #         # #         #         #
# # ### # # ############# # # ##### # # ### ### # ##### # # ### ############# # # ##### # ### ######### # # ### ### ### # # # ### #######
# # #   # #             # # #     # # #   #   # #     # # #   #             # # #     # #             # # #   #       # # # #   #       #
# # ### ### ### # # # ######### ### # # ####### ############# ### # # # ### ################# # # ####### ##### ##### ###################
# # #   #     # # # #         #   # # #       #             #   # # # #   #     # #         # # #       #     #     # # # #       #     #
# # # # # # # ### # # # # # ##### ############# ################# # # # # ### ### # ######### ##### # ### # ### ####### # # ####### ### #
# # # # # # #   # # # # # #     #         # # # #               # # # # #   #               #     # #   # #   # #                     # #
# # # # ### # ### ################### ##### # ### ##### ### ##################### # ####### # # # ######### # # # ##### ##### # ##### ###
# # # # #   #   #                   #     # # #       #   #                     # #       # # # #         # # # #     #     # # # # #   #
# # # # ### # # ### # # # # ### ### ####### # # ### # ####### # # ##### ### ##### # ### ##### ### ############### ### ### ####### # #####
# # # # #   # #   # # # # #   #   #   #   #       # #       # # #     #   #     # #   #     #   #   #               #   #               #
# ### # # # # # # # ### ### # # ####### ### ######### ################# ##### # # # ### ##### ####### ########### ##### # # ######### ###
#   # # # # # # # # # #   # # #                     #               # #     # # # #   #     #                   #     # # #         #   #
# # ### ### # # ##### # ### # ######### ##### # ########### # # ##### ##### # # # # # # # ### # ### # # ############# ##### ### ### #####
# #   # #   # #       #   # #         #     # #   # #     # # #           # # # # # # # #   # #   # # #             # #   #   #   #     #
# # ### # # # # # ### # ### ### # # # ####### # ### # ### ############### ##### # # # ### # ### # # ### # ### ### ##### #################
# # #   # # # # #   # # # #   # # # #       # #   #     #               #     # # # #   # #   # # #   # #   #   # #                     #
# # ### # ### # # # # # # # # ########### # ### ### ########### ### # # # # ##### # ### ### # # ### # # ### ####### ############# # # # #
# # #   #   # # # # # #   # #           # #   #               #   # # # # #     # #   #   # # #   # # #   #                     # # # # #
### ### # # # # # # ### # # # ### ######### ### # ############# ### ### # ### ### # ####### ### ##### # # # # # # ### ######### # # # ###
#   #   # # # # # #   # # # #   #         #   # #             #   #   # #   #   # #       #   #     # # # # # # #   #         # # # #   #
### ### ### # # # # ### # # ##### ########### # # # # ### # # # # ### # ### ##### # # # ####### # # # # # # ### # # ######### # # # # # #
#   #     # # # # #   # # #     #           # # # # #   # # # # #   # #   #     # # # #       # # # # # # #   # # #         # # # # # # #
### # # ### # ### ######### ####### ### ##### # # # # ### ##### # ##### # ##### ### ### # # # # ####### # # # ### ##### ########### #####
#   # #   # # # #       #         #   #     # # # # #   #     # #     # #     #   #   # # # # #       # # # # #       #     #   # #     #
# # ### ### # # ##### ##### # ### # # ### # ##### # ### # # # # # # ### # ### # ####### ### ##### ##### ### # ### ### # ##### ### ### # #
# # #     # #       #   #   #   # # # # # #     # #   # # # # # # # #   #   # #       #   # #   #     #   # # #     # #             # # #
####### # ### # # ### ##### # ### # ### ######### # # ### ##### # ##### ####### ############# ######### ######### ##### ### # # ### # ###
#       # # # # # #       # #   # #             # # #   #     # #   #         #                       #         #     #   # # #   # # # #
### # # # # # ### ### ####### ### # # # # ### ##### # ############# ### # ### ### ################# # # ##### # # ######### # ######### #
#   # # #   #   #   #       #   # # # # #   #     # #   # #       # #   #   #   #                 # # #     # # #         # #           #
### # # # # # # ### # # # ### # ### ### ### # # ##### # # # ######### # # # # # ### # # # # ### ### # ### ### # # # ### # # # # # ### ###
#   # # # # # #   # # # #   # #   # # #   # # #     # #             # # # # # #   # # # # #   #   # #   #   # # # #   # # # # # #   #   #
### # # ### # ##### # # # ### # ### # ### # ### ##### # ### ### ######### # ### ##### # ### ### ##### ##### ##### # # # # # # # # # # ###
#   # # #   #     # # # #   # #   #     # #   #     # #   #   #         # #   #     # #   #   #     # #   #   #   # # # # # # # # # #   #
# # # ### # # # # # ### # # # # ##### # # # ##### # ### ### ### ######### ##### ##### ### # ######### # ##### ### # ################# # #
# # #   # # # # # #   # # # # #     # # # #     # #   #   #   #         #     #     #   # #         #   #   #   # #                 # # #
# # # # # # # # # # ### # # # # # # ### ### # ### ### ####### # # ##### # ##### # ############### # ##### ##### # # # ######### ##### # #
# # # # # # # # # #   # # # # # # #   #   # #   #   #       # # #     # #     # #               # # #         # # # #         #     # # #
##### # ### # # # ### ### # ### # # # # # # # ##### ######### ### # ### ### ### # # ################# ##### # # ####### # # ##### #######
#     # #   # # #   #   # #   # # # # # # # #     # #     # #   # #   #   #   # # #           # #         # # #   #   # # #     #   #   #
# # # ### # ### # ### ### # ##### # ### ### ####### # ##### ########### # # ########### ####### # ####### # # ##### ### ############### #
# # # #   #   # #   #   # # #     #   #   #     # #     #             # # #           #     #           # # #         #   #             #
### ##### # ### # ##### # # # # # # # ### # # ### ### # # ### ### ### # ### # # # # # ### ### ##### ####### ##### # ####### ### ####### #
#   #     #   # #     # # # # # # # #   # # #     # # #     #   #   # # #   # # # # #   #         #       # #   # #           #       # #
### ### # # # # # ### ### # # # # ### ##### # # ### ##### # # # ####### ### # # # ### ### ##### ############# ######### ############# # #
#   #   # # # # #   #   # # # # #   #     # # #         # # # #       #   # # # # #     #     #           #         # # #     # #   # # #
# # ### ### # ### # # ### ####### # # ##### # # # # # # # # ############### ### ##### ### # ##### # ####### ######### ### ##### # #######
# # #   #   # #   # #   #       # # #   #   # # # # # # # #               #   #     # #   #     # # #     #         #                   #
# # # ### # # # # # ########### # # # # ### # # # # ##### ### # ##### ##### ### # # ##### # # # # # # ##### ######### ####### # # ### # #
# # # #   # # # # #           # # # # #   # # # # #     #   # #     #     #   # # #   #   # # # # #             #           # # #   # # #
# # # ### ### # # # # ####### ### ### ### # ### # # ##### ### # ### ### # ##### # # # ### ### # # ##### ### # ### ######### # ### # #####
# # # #   #   # # # #       #   #   #   # #   # # #     #   # #   #   # #     # # # #   #   # # #     #   # #             # #   # #   # #
# ### # # # # # # # ##### # # ### # # ##### ####### ### # ### ### # ##### # ##### # # ### # # # # # ####### # # # # ######### ### ##### #
# #   # # # # # # #     # # #   # # #   #         #   # #   #   # #     # #     # # #   # # # # # #       # # # # #         #   #       #
# ##### # ##### # # ### ### ####### # ### # # ### ########### # ### ##### # ##### # # ##### ##### # # ### ### # # ### # # ########### # #
# # #   # #     # #   #   # #   # # #   # # #   #   #   #   # #   #     # #     # # # #         # # #   #   # # #   # # # # #       # # #
# # # # # ##### # ### # ##### ### # ##### # ######### ### ##### ### ##### ########### ### # ####### ### ### # ### # # ##### # ###########
# #   # # #     #   # #           # #   # #                 # #   #     #         #   #   #       #   #   # #   # # #           # # #   #
# # # # # ##### # # # # ### # # ##### ##### ##### ####### # # ##### ### ##### # # ######### ####### ### ### ##### # # # ##### # # # # ###
# # # # # #     # # # #   # # #       #         #       # #       #   #     # # #       #         #   #   #     # # # # # # # #         #
# # # # # # # # # # # # # # # # # # # # ### ### # # # ### ##### # ### # ##### ##### # # # # ####### # ### ### ##### # # # # ######### ###
# # # # # # # # # # # # # # # # # # # # #     # # # #   #     # #   # #     #     # # # # #       # #   #   #   #   # #             #   #
# # ### ### # # # ### # ### # # # # ### # # # ### ####### # # ######### # ##### ######### # ##### # ####### # # ##### # ### ##### # # ###
# # #   #   # # #   # #   # # # # #   # # # #   #       # # #   #     # #     #     # # # #     # #       # # #   #   #   #     # # #   #
##### # ##### # # # # ##### ### # # # ##### ### # # ##### # ##### ### ######### ##### # # # ####### # # ##### # ##### # ### # # # ### ###
#     # #     # # # #     #   # # # #     #   # # #   #   #         #         #         # #       # # #     # #     # #   # # # #   #   #
# ### ####### # # # # # ##### # # # # ##### # # ### # ### # ### ######### ####### # # # ### ####### # # ### ### # # # # ### ########### #
# #   #       # # # # #     # # # # #     # # #   # #   # #   #         #       # # # #   #       # # #   #   # # # # #   #           # #
# # ### ##### # # ### # ####### ### # # # # # # ### ### # # # ##### # # ##### # ### # ##### ####### # ##### # # ####### ### ### ### #####
# # #   #     # #   # #       #   # # # # # # #   #   # # # #     # # #     # #   # #   #       # # #     # # #       #   #   #   #     #
# ### # ##### # # ### # # # ### ### # # # # ### # # # # # # ##### ### ### # # # # # # ### # # ### ##### ### ### # # # # ### # ##### #####
# #   # #     # #   # # # #   #   # # # # #   # # # # # # #     #   #   # # # # # # #   # # #         #   #   # # # # #   # #     #     #
# ### # # # # # # ##### # ### ##### # # # # # ### # ### # # # # # ### # # ##### # ### # # # # # ########### # # # ##### # # ##### # # ###
# #   # # # # # #     # #   #     # # # # # # #   # #   # # # # #   # # #     # # #   # # # # #           # # # #     # # #     # # #   #
### # ### # # # # ### ### ####### ### # ### ### # ##### # ### ### # # ##### ######### ### # # # # ### # # # ### ##### # # # # ### # # ###
#   # #   # # # #   #   #       # #   # #     # #     # #   #   # # #     # #   #   #   # # # # #   # # # #   #     # # # # #   # # #   #
# # ### ### # # # # ##### ####### ### # # # ### # # # # ### # # # # ######### ### ### # ### # ### ####### # # # # # ### # ### # # # ### #
# # #   #   # # # #   #       # #   # # # #   # # # # #   # # # # #                 # #   # #   #     # # # # # # #   # # #   # # #   # #
# # # # # # # ### ### ### # # # ##### # # # # ##### ########### ####### ##### ##### ######### # # # ### # ##### # # ### # # # ##### # ###
# # # # # # # #     # #   # #       # # # # # #               #       #     #     #         # # # #     #   #   # #   # # # #     # #   #
# ##### ######### # ##### # # ### ### # # # # ### # ############# ########### # ### ######### # # # # # # ### # ### ### # # # # ### #####
# #     #       # #   # # # #   #   # # # # #   # # #           #           # #   #         # # # # # # #   # #   #   # # # # #   #     #
##### # ### # # # ##### # # ### ### ### # # # # # # # ##### ############### # ### ######### # # ### ### ##### # ### # # # # # ##### ### #
#     #   # # #         # #   # # # #   # # # # # #       #               # #   #         # # #   #   #     # #   # # # # # #   #     # #
##### # ##### # # ### ### # # ### ##### # # ### ### ### ##### ##### ####### # # ####### # ######### # # ##### ### # # ### # # ### # ### #
#     #   #   # #   # #   # #         # # # #   #     #     # #   #       # # #       # #         # # #     #   # # #   # # #   # #   # #
### ### ##### # # # # # # ### # ####### # ### # ### ### ### ### ### ### ##### ######### ### # # # # # ####### # # # ##### # # # # # ### #
#   #   #     # # # # # #   # #       # #   # #   #   #   #       #   #     #         #   # # # # # #       # # # #     # # # # # #   # #
####### ##### # # ### # # # # ### # # ### ##### ### # # # ##### # ##### ##### ### ##### ### ##### # # ### # ######### ### # # # ### # ###
#       #     # #   # # # # #   # # #   # #       # # # #     # #     #     #   #     # # #     # # #   # #         #   # # # # #   #   #
####### ### # # # # # # # ### # # # ##### ##### ### ##### # # ### # ####### # ### ### ### ####### # ### ### ### ### # ### # # ### # # ###
#         # # # # # # # #   # # # #     #   #     #     # # #   # #       # #   #   #           # #   #   #   #   # #   # # #   # # # # #
####### ### # # ### # ### ### # ##### ### ##### ### # # # ### # # ##### # # ##### # ######### ### ### # ### # # ### # # # # # ####### # #
#         # # #   # # #     # #     #   #     # # # # # #   # # #     # # #     # #         # # #   # #   # # #   # # # # # #     #     #
### # # # ### ##### # # # # # ### ### ##### ### # # ######### ##### # # # # ####### ####### ### ### # ### # ### ### ### ### # ##### # ###
#   # # # #       # # # # # #   #   #     # #     #     #   #     # # # # # #     #     # #       # #   # #   #   #   #   # #   #   #   #
##### # # ### # ### ##### # ####### ##### ### # ### # # # ####### # # # ##### ### # # ### ####### ##### # # # # ##### # # # # # # # # ###
# #   # # #   #   # #     #       #     #   # #   # # #         # # # #         # # #           #     # # # # #     # # # # # # # # #   #
# # ####### # ##### ### # # # # # ### ### # # # ### # # # ####### # ### ##### ##### # ### # # # ##### # # # # # ### ### # # # ##### # # #
# # #       #     # #   # # # # #   #   # # # #   # # # #       # #   #     #     # #   # # # #     # # # # # #   #   # # # #     # # # #
# ### # # # # # ### ##### # # ### # # # # # ### # ### ### ### ########### # # # ##### # # # # # # # # # ### # ##### ### # # # # # # # ###
#     # # # # #   # #     # #   # # # # # # #   # # #   #   #           # # # #     # # # # # # # # # # #   #     #   # # # # # # # #   #
##### # # # # ### ##### # # # # # ### ### ### # ### # # # ##### # ### ############### # # ### ### # # # # # # # ##### # ##### # # # # # #
#     # # # #   # #     # # # # #   #   #   # #     # # #     # #   #       #       # # #   #   # # # # # # # #     # #   #   # # # # # #
# ### # # # ########### # # # ##### ##### ### # ######### # ### # # ### ##### ############### # # ######### ### # ##### ##### ### # # ###
# #   # # #       #     # # #     #     # #   #         # #   # # #   #                     # # # #       #   # #     #     #   # # #   #
### # ### # # # # ####### # ######### ### ##### ### # ### ### # ### ### # # # ########### # ####### ####### # # # ##### ##### # # # #####
#   # #   # # # # #       #         #   #   #     # #   #   # #   #   # # # #           # #           #   # # # #   #       # # # # # # #
# # # ### # # # # ##### # # # ### # ########### # # ##### # ### ### # # # ### ##### ##### ##### ####### ### ##### ######### ##### ### # #
# # # #   # # # # #     # # #   # #   #     #   # #     # #   #   # # # # #       #     #     # #   #   # # #   #         # # # #   #   #
### # # # # # # # ####### ### ####### # ####### # # # # # ##### ### # ### ### ##### # # # # ##### ### ### ### ##### # # # # # # # ### ###
#   # # # # # # # #       #       # #       # # # # # # #     #   # # # # # #     # # # # #           #   #       # # # # # #   # #     #
# # # # # # # # ### # # # ### ##### ####### # ######### # ##### ##### # ### # ########### # ####### ### ### ####### ##### ### ##### ### #
# # # # # # # #   # # # #   #             # #         # #     #   # # #     # #     #   # # #     # #             #     # # # #       # #
# # # ### # ##### # ##### # # # # ####### ### ############### # ### ### ####### ##### ##### # ####### ### ################# # # ### # ###
# # # # # #     # # #     # # # #       #         # #       # #                   #     # #             # #         # # # # #     # #   #
# ### # # ### ####### ##### # # ### # ### ######### # ### ########### ############# ##### ####### ####### # ######### # # # # ####### # #
# #     #   #   #     #     # #   # # #                 #           #                           #       #                         #   #x#
#########################################################################################################################################
