#########################################################################################################################################
#o                #       #                 #           #   # # #   # # # # # # #       # # # # # #         #     #           #   #     #
# # # ######### ### ####### ################# ########### ### # ### # # # # # # # ####### # # # # # ######### ### # ############# # #####
# # #         #         #   # #   #           #   # #     #         #   #   #   # # #       # #         #       #             #         #
# # ### # ### # # # # ### ### # ### ########### ### # ##### ######### ### ### ### # # ####### # ######### ########### ######### #########
# #   # #   # # # # #     #   #                         # #   # #   # #   #                                         #             #   # #
# # # ##### ### ########### ### ### ##################### # ### # ### # ### ##### # # ### # # # ####### # # ### ############### # # ### #
# # #     #   #         # #       #   #     # #     # #         # # #   #       # # #   # # # #       # # #   #     #         # #       #
# # # # # # # ########### # ########### ##### # ##### # ####### # # # ### ########### ### # # ##### ##### ########### ####### ##### # ###
# # # # # # #             #                       # # #   #   #     #               #   # # #     #     #         #         #     # #   #
# ### # ### # ### # ####### ########### # ######### # # ### ######### ######### ##### ##### # # # ####### ######### ####### #############
#   # #   # #   # #   # # #         # # #   #     # #   # #   #   #           #     #     # # # #       #                 #     #     # #
# # # # ######### ##### # # ### # ### ####### ##### # ### # ### ### ### # # # # # # # # ##### ##### ##### ##### ####### # ####### ##### #
# # # #         #       #     # #         # #   #                     # # # # # # # # #     #   # #   #       #       # #               #
# ##### ### ### ######### ##### ##### ##### # ### ############# ##### ######### ####### ######### ############# ########### # # # # #####
#   #     #   #               #     #       #                 #     #         # #     #   #                   #           # # # # #     #
# ### # ### # # # # # ##### ### ##### ### ### ### ######### ### # # ############# ######### ####################### # ##### # ### # #####
#   # #   # # # # # #     #   #     #   #       #         #   # # #                   # # #                 # #   # #     # #   # #     #
# # ### # ### # # # ### ### # # # ### ### ####### # ##### ### # # # # ### ##### ####### # # ##### ####### # # # ##### ### # ##### # # ###
# #   # # #   # # #   # #   # # #   #   #       # #     #   # # # # #   #     #                 #       # # # # #   #   # #   #   # #   #
# # # ### # # ### # # # ### # ##### # # # # # ### ### # ### # # # ### # ############### ### ### ############# # # ##### ############# # #
# # #   # # # #   # # #   # #     # # # # # #   #   # #   # # # #   # #               #   #   #   #     # #         # #             # # #
# ####### ### # # ####### ### # # # # # # # ############# ####### # # # ##### # ####### ### ####### ##### # ### ### # ######### # ##### #
#       # #   # #       # #   # # # # # # #   # #       #   #   # # # #     # #       #   #             # #   #   #   #     # # #   # # #
# ### ##### # # # # ##### # # # # # # # # ##### # ########### ### # # ####### # ####### # # ### ##### # # # ### ####### ##### ####### # #
#   #   #   # # # #     # # # # # # # # #     # #               # # #       # #       # # #   #     # #       #                 #     # #
# ### # ### # # # # ### ### # # # ### # ####### # ##### # ####### # # # # ##### # # ### # # ### ##### ### ### # # # ####### ### # ##### #
#   # # #   # # # #   #   # # # #   # #               # #       # # # # #     # # #   # # #   #   # #   #   # # # #       #   #       # #
# # # # # # # ### # # ### # ### ##### ### # # ### # # ### # # ### # # ### ### # # ##### ########### ##### ####### # ##### # # ### # # ###
# # # # # # #   # # #   # #   #   #     # # #   # # #   # # #   # # #   #   # # #     #   #   #         #   # #   #     # # #   # # #   #
# # # # ##### # ### # ### # ### # ### ### # ### ######### # # # # # # # # # ### ########### ### ##### # # # # ##### # # # # ######### ###
# # # #   #   #   # #   # #   # #   #   # #   #       # # # # # # # # # # #   #   #       # #       # # # #       # # # # #         #   #
# # ##### # # # ### # ### # ### ##### ### # ### # # ### ######### # # # ### # # # # ####### # ### ##### ########### # ##### #############
# #     # # # #   # #   # #   #     # #   #   # # #             # # # #   # # # #               #     #           # #     #             #
# # # # # # # # # # ### # # # ##### # # # # # # # # # ##### ### ##### # ##### # # # ### ##### ##### ##### ##### # ############### #######
# # # # # # # # # #   # # # #     # # # # # # # # # #     #   #     # #     # # # #   #     #     #     #     # #               #       #
# # # # # # # ##### # # # # ### # ####### # # ### ### # ##### ########### ##### # ##### # # ### # ##### ##### ##################### # # #
# # # # # # #   #   # # # #   # #     #   # #   #   # #     #           #   # # #     # # #   # #     #     # # #                 # # # #
### ### ### # ######### ### # # # # ##### # # # # # # ### # ########### ##### # # # # # # # ##### # # ######### # ########### ######### #
#     #   # #         #   # # # # #   #   # # # # # #   # #           #       # # # # # # #     # # #             #         #       # # #
# # ### # ### ### ### ####### # ##### ### # ####### # # # # # ### # # ##### ### # # # # # # # # # # # # ### # # ### ##### ##### ##### # #
# # #   #   #   #   #       # #     #   # #   #     # # # # #   # # #     #   # # # # # # # # # # # # #   # # #   #     #     #       # #
# # # # # ####### # ### ### # # # ### ### # ##### # # # # ### ### ### # ##### ### ########### ### ##### ### # # # # ####### # ### ### # #
# # # # #       # #   #   # # # #   #   # #     # # # # #   #   #   # #     #   #           #   #     #   # # # #         # #   #   # # #
# # ### # ### ##### # # # # ### # ####### # # # # # # # ######### # # # # # # # # ############# ##### # ### ### # ######### # # # #######
# # #   #   #     # # # # # #   #       # # # # # # # #         # # # # # # # # #             #     # #   #   # #         # # # # #   # #
# # ### # # ### ##### # ####### # # ####### # ### # # # # # # ######### ##### ### ####### ##### ##### # ### # # # # ####### ### # # ### #
# #   # # #   #     # #       # # #       # #   # # # # # # #         #     # #         #     #     # #   # # # # #       #   # #       #
# # # # # # # # ##### # ######### # # # ### # ##### # # # # # ### ####### ### ### # ### # # # ######### # # # ##### # ### ####### #######
# # # # # # # #     # #         # # # #   # #     # # # # # #   #       #   # #   #   # # # #         # # # #     # #   #       #     # #
# # ### # # ########### # # # ##### ### ### ####### ### # ### # ### ############# # ####### ############### ### ### # ######### # ##### #
# # #   # #           # # # #   #     #   #     #     # # #   #   #             # #       #     #         #   #   # #         # #   # # #
# # # # ### # ##### # # # # ##### # ### ### ####### # # ##### # ############# ### # ##### # ##### ############### # # ### ### ### ### # #
# # # #   # #     # # # # #     # # # #   #       # # #     # #             # #   #     # #                     # # #   #   #   #       #
# ##### ### # ####### # ### ### ### # ##### # # # ### ### ### # # # # ### ####### # # # ####### # ####### ##### # # # # # ### # # #######
#     #   # #     # # #   #   # #         # # # # #     # #   # # # #   #     #   # # #       # #       #     # # # # # #   # # #       #
# # ### # ### ##### ##### ####### # # # ### ### ##### # # # # # # # # ### # # ### # # # # # # # ### # # # ### # ### # ### ### # ### # # #
# # #   # #             #       # # # #   #   #     # # # # # # # # #   # # #   # # # # # # # #   # # # #   # #   # #   #   # #   # # # #
# ##### # ### ##### ########### # # # # # # # ### ### ### ##### # ### # # # # # # # # # # ####### # ##### # # ### # # ### ####### # #####
# #     # #       #           # # # # # # # #   #   #   # #   # #   # # # # # # # # # # #       # #     # # #   # # #   #       # #     #
# ##### ##### ### ####### # ### # # # # ##### ##### # # ### # # # # # ##### # ### # # # ##### # # ### # # # # # # # # # # # ########### #
# #   #     #   #       # #   # # # # #     #     # # # #   #   # # #     # #   # # # #     # # #   # # # # # # # # # # # #           # #
# ### # # ### # # # # # # ### # # # # # ##### ####### ### # # # # # ### ### # # # # # # ### # ### ### # # ######### ### # # # ### ### # #
# #     #   # # # # # # #   # # # # # #     #       # # # # # # # #   #   # # # # # # #   # #   #   # # #         #   # # # #   #   # # #
####### # ### # # # # ##### # # # # # # # ### # # # # # ### # # # # ### ##### ### # ### # ##### ################# # ##### # # # ### # # #
#       # #   # # # #     # # # # # # # #   # # # # #   #   # # # #   #     #   # #   # #     #                 # #     # # # #   # # # #
### # # ##### # ### ####### ### ### ### ####### ##### # # # # # ################# ####### # ##### # # ### ########### # ##### ### # # # #
#   # #     # #   #       #   #   #   #       #     # # # # # #               # #       # #     # # #   #           # #     #   # # # # #
# ### # # # # # # # # # ### ### ### # # # ##### ### # ######### # ##### ### # # ####### # # # ### # # # # ####### ### ####### # # ### # #
# #   # # # # # # # # #   #   #   # # # #     #   # #   #       #     #   # #         # # # #   # # # # #       #   #       # # #   # # #
# # # # ### # # # ####### # ##### # ### # ### # # # # ##### # # ### ########### ### # # # # ##### ### ### # ### # # # # # ##### # ##### #
# # # #   # # # #       # #     # #   # #   # # # # #     # # #   #           #   # # # # #     #   #   # #   # # # # # #     # #     # #
# # ### # # # # ### # ##### # # # # # # # # # # ##### ####### # # # # ### # # # # # # # # ### ### # # ### # ####### ### ### # ### # ### #
# # #   # # # #   # #     # # # # # # # # # # #     # #   #   # # # #   # # # # # # # # #   #   # # #   # #       #   #   # #   # #   # #
### # # # # # # # # # # # ##### # # # # ### ### ####### ### # # ### ### # # # # # # ##### ### # # ### ####### ############# # ###########
#   # # # # # # # # # # #   # # # # # #   #   #     #     # # #   #   # # # # # # #   #     # # # #         #             # #           #
### ##### # # # # ####### ### # ### # # # # ### ##### ####### # ### ##### ##### ### # ### # # ##### # ### ### # ### # ### ### # # #######
#     #   # # # #       #     #   # # # # #   #         #     #   #     #     #   # #   # # #     # #   # # # #   # #   #   # # #     # #
### ### # # ### # ### # # # ### ### ### ### # # # # ##### # # ### # ####### # ##### ### # ### # # ### # ### ######### ####### # # ##### #
#   #   # # #   #   # # # #   #   # #     # # # # #     # # #   # #       # #   #     # #   # # # #   #             #       # # #       #
### ##### # ### # # # # # # ####### ### # ##### # ### ### # # # ### ##### ##### # # # # # # ### # ### # ### ############### #############
#     #   #   # # # # # # #       # #   #     # #   #   # # # #   #     #     # # # # # # #   # #   # #   #               #     #       #
# # # ### # ##### ### ############# ### ### ### # ### # # # # # # # # ######### # # ##### # ######### # # # # ##### ############# ### # #
# # #   # #     #   #             # #     #   # #   # # # # # # # # #         # # #     # #         # # # # #     #                 # # #
# # # ### # # # # ####### # # # ### # # ### ##### ######### # # # # # ######### ### # # # # # ### ##### # # # # # # # # # ##### #########
# # #   # # # # #       # # # #   # # #   #   #           # # # # # #         #   # # # # # #   #   #   # # # # # # # # #     #         #
# # ##### # # ### # ### ### ##### # # # # ########### # ##### ### ### # ####### # # ### # # # # ####### ### # ### # ### ### #############
# #     # # # #   #   #   #     # # # # #           # #     #   #   # #       # # #   # # # # #       #   # #   # #   #   #   #         #
# # # # # ##### # # ### ##### # ### # ### # ### ##### # # ### # # ### ### # ########### # ### # ### ### ##### ### # # ### ### # ##### # #
# # # # #     # # #   #     # #   # #   # #   #     # # #   # # # #     # #   # #     # #   # #   #   #     #   # # # # #   #       # # #
# # ### # # # # # # ##### # ####### ### # # # # ### # # # ### ### ### ######### # ######### ### # # ### ##### ### # ### ########### ### #
# #   # # # # # # #     # #     #     # # # # #   # # # #   #   #   #                     #   # # #   #     #   # #               #   # #
### ##### ### # # # # # # # # # # # # # ### # # ##### # ##### ### ### # ### ##### # ##### ##### # # ### ##### ##### # # ####### #########
# #     # #   # # # # # # # # # # # # #   # # #     # #   #     #   # #   #     # #     #     # # # #       #     # # #       #         #
# # ### ### # # # # # ######### ### ### # # # # ####### ### # ### # # ####### # ### # # # # ### # ##### ### # # # # ### ##### # # # # ###
#     #   # # # # # #         #   #   # # # # #       #   # # #   # #       # #   # # # # #   # #   #     # # # # #   #     # # # # # # #
### # # # # ### # # # # ### ##### # # # ### # # ####### # ##### # # # # # # # ##### # ### # ### # ### # # # # # ### # # ### # ####### # #
#   # # # # #   # # # #   #     # # # #   # # #       # # #     # # # # # # #     # #   # #   # #   # # # # # #   # # #   # #       # # #
### # # # # # # # # # # # # # # # # # # # ### # # # ### # ##### # ### # ##### ### ######### ### # ##### # # ### # # # # ### # # # ##### #
#   # # # # # # # # # # # # # # # # # # #   # # # #   # #   #   # #   #     #   #         #   # #   #   # #   # # # # #   # # # #       #
### ### ### ### # # # ##### # # ##### ##### ### # # # # # ### # ##### # # ### ### # ####### # # ####### # ##### ##### # # # ##### #######
#     #   # #   # # #     # # #     #     #   # # # # # # #   # #     # #   #   # #       # # #       # #   #     #   # # #   #         #
# # # # ### # # ### # ##### # # # # # ####### # # # # ### # # # ##### # # # # # # # ############### ### # # # # # ### ### # # # # ### ###
# # # #   # # #   # #     # # # # # #       # # # # # # # # # # # #   # # # # # # #               #   # # # # # #   #   # # # # #   #   #
# # # # ### # # ##### ##### # # ### ### # ##### ### # # ##### # # # # ### # ######### # # ##### ####### # # ##### # # ### # # ### # # # #
# # # #   # # #     #   # # # #   #   # #     #   # #     #   # #   #   # #         # # #     # #     # # #     # # #   # # #   # # # # #
### # # ### # # ##### # # # # # # # ### # # ### ### # ##### # ### # # # ##### ### ##### ####### # ##### ##### # # # # ### # ##### # ### #
#   # #   # # #     # #   # # # # #   # # #   #   # #   #   # #   # # #     #   #   #         #       #     # # # # #   # #     # # # # #
# # # # ### # # # # # # # # # ### # ##### # # ####### # ### # ### # # ########### # ### # ### # # # # # # ### # # # # # # ### ### ### ###
# # # #   # # # # # # # # # # #   #   # # # #   # # # # #   # #   # #           # # #   #   # # # # # # #   # # # # # # #   # # #       #
# # # # # ### ### # # ### # # ##### ### # ### # # # ####### ##### # # # # # ### ### ### # # ############# ##### # ### ##### # # ### # # #
# # # # #   #   # # #   # # #     #     #   # #           # #     # # # # #   #   # #   # #             #     # #   #     # #     # # # #
### ### ### # # # ### # # # # # # ####### ### # # # # ######### # ### # # # ### # # ######### # ######### ### ### # # ######### # # ### #
#   #     # # # #   # # # # # # #       #   # # # # #       #   # #   # # #   # # # # #     # #         #   # #   # #         # # #   # #
### # # # ### ### ##### # ### ####### # # ##### # # ##### # # # # # # # # # ######### # ####### ### ##### # ##### # # # # ### ### ### # #
#   # # #   # #       # #   #       # # #     # # #     # # # # # # # # # #                   #   #     # #     # # # # #   #   #   # # #
# # ### # # # ### ### # # ### # ### # ### # ### # # ### ##### ### ### # ### # # ######### # ### # # # # ### # ### # ### # ### ######### #
# # #   # # # #     # # #   # #   # #   # #   # # #   #     # #   # # #   # # #         # #   # # # # #   # #   # #   # #   #         # #
# ### # # # # # # # ######### ### # # # ### # ### # # # ######### # # # ### # ### # # # ############### # # # # # # # ### ### # # # ### #
# #   # # # # # # #       #     # # # # # # # #   # # #     #       # # #   #   # # # #               # # # # # # # #   # #   # # #   # #
# ### ### # # ### ##### # # # # # ##### # ### ### # ##### ### ### ### ### # # # # # ### ####### ##### ####### ##### ######### # # #######
#   # #   # # # #     # # # # # #     #     #   # #     #   # #     #   # # # # # #   #       #     #       #   #   #       # # #       #
# ### ### # # # # ##### # ### ### ### ### ### ### # ### # ##### # ### # ### # # ### ### # ##### # ####### # # # ### # ####### # # # ### #
#   # #   # # #       # # #     #   #   #   #   # #   # #   #   #   # #   # # #   #   # #     # #       # # # # #           # # # #   # #
# # # # # # # # # # # # ### # # # # # ######### # ##### # ####### # # ### ### ####### ### ##################### # # # # # # # # # # #####
# # # # # # # # # # # # #   # # # # #         # #     # #   #     # #   # #         #   #         # #   #     # # # # # # # # # # #     #
# ### ### ##### # ### # ### # # ### ### # # # # # # # # ### ### # # ######### # ######### # ####### # ### ### # # # # # # # # ### # # # #
# #   #       # #   # #   # # # # #   # # # # # # # # #   #   # # #         # #         # #                 # # # # # # # # #   # # # # #
# # # # # ##### # # ### # ### ### # ### # ### ### # ####### ### # # # ### ### # ### # ##### ### ### ### ### ####### # # # # # # ### ### #
# # # # #   #   # # #   #   #     #   # #   #   # # # #   #   # # # #   #   # #   # #     #   #   #   #   #       # # # # # # #   #   # #
### # ### # # # # ### # # ### ##### ##### # ##### # # # ##### ### # # ### ### ### # ####### # # ######### # # ### # # # ### # # # ### ###
#   # #   # # # # # # # #   #     #     # #     # #       # # #   # #   #   #   # #   #   # # #         # # #   # # # #   # # # #   # # #
##### ### # # # ### ##### ### # ### # ############# ### # # ####### # ##### # # ### ### ### ### # ####### # ### # # # # ####### ### ### #
#     #   # # #       # #   # #   # #             #   # #       #   #     # # #   #       #   # #       # #   # # # # #       #   #     #
######### # ### # # # # # ### # ### ##### # ####### # ####### # ### # ##### # # ####### ##### ### ### ##### ######### ########### ### ###
#         #   # # # # #   #   #   #     # #       # #       # # #   #     # # #       #     #   #   #     #       #             #   #  x#
#########################################################################################################################################
