#########################################################################################################################################
#o    # #         #             #           #   #       #                   # #         #             # #   #               # #       # #
# # # # # ######### ############# ######### # ### ### ### ##### # ########### # ######### ############# ### # ######### ##### # ####### #
# # #                   #                 #         #       # # #   #   #   #   #     # #           # # #             #       #         #
# # # # ######### ### # # ### ################### # # # ##### ####### ### ### ### ##### # ########### # # ####### # ### ####### #########
# # # #   #     # # # #     #                   # # # #             #                 #                         # # # #           #     #
# # # # # # ####### ##### ### # # ### ######### # ####### ### # ##### ######### ### ### ### ######### ### # ##### ### ############# #####
# # # # #       #       #   # # #   #         # #       #   # #               #   #       #         #   # #   # #   # # #         #     #
# # ### ### ##### ##### # ### # # # ##### ##### ######### ### ####### ####### ##### # # ### ##### ####### # # # ##### # # ##### ### #####
# #   #   #           # #   # # # #     #     #         #   #       #       #     # # #   #     #       # # #       #         #         #
# # # # ####### ####### ### # ### ##### # ####### # ### ### # ##### # ### # # ### # # ### # ######################### ##### # # # ### # #
# # # #       #       #   # # # #     # #       # #   #   # #     # #   # # #   # # #   # #               #     # #       # # # #   # # #
# # # # ######### ######### ### ### ### # ##### # # ### ##### ####### ### # ######### ######### # # # ### # ##### ### ####### ###########
# # # #         #       # #       #   # #     # # #   #     #       #   # #         #         # # # #   #     #             #           #
### # # ########### ##### ### ### # ### # # # ####### # # ##### ##### # ### # ### ### # # # ### # # # ######### ######### ### ### # #####
#   # #           #         #   # #   # # # #       # # #     #     # #   # #   #   # # # #   # # # #                   #   #   # #     #
# # # ############# ####### ########### # # # # ####### # ### # # # # ##### # # # # # # ### ### # ### # # ### # ### ### # ####### # # # #
# # #             #       #     # # # # # # # #   #   # #   # # # # #   # # # # # # # #   # #   #   # # #   # #   #   # #       # # # # #
### # # # ### ### # ####### ##### # # ######### ### ### # ##### # ####### ####### ##### ### ########### ### # # # ### # # ######### #####
#   # # #   #   # #       #   #               #       # #     # #               #     #   #           #   # # # #   # # #         #   # #
# # # # ### ### ##### # # # ### ######### ##### ### ##### # ### ### # ##### ### # ### ### # # ######### # ### ### ############# ####### #
# # # #   #   # #   # # # # #     #     #     #   #     # #   #   # #     #   # #   #   # # # # #     # #   # #               #         #
# # # # # ### ### ##### ##### ##### ######### ### ####### # # # # # # # # # ################### # ##### # # # ### # ####### # # # ##### #
# # # # #   #       # #                     # # #       # # # # # # # # # # #             #           # # # # # # #       # # # #     # #
# # # # # # ### # # # ######### # # # ######### ######### # ### ### ### ##### ############# ####### # ##### ### # ########### # # # ### #
# # # # # #   # # #           # # # #       #       #   # #   #   #   #   #           # #       # # #     #     #           # # # #   # #
# # # # # # # # ### # ### ####### # # # ##### ##### # ### ### # ########### ### # # # # # ####### ### # ##### ### # # # ####### # ##### #
# # # # # # # # #   #   #     # # # # #           #     #   # # # #   #   # # # # # #               # #     #   # # # #       # #     # #
# # # # # ### # ######### ##### ##### # # # ##### ############# # # ### ### # ##### ### ### ##### ##### # ####### # # # ### # # ### #####
# # # # #   # #         #           # # # #     #           # #         #   #   # #   #   #     #     # #       # # # #   # # #   #     #
# # # # # # ### # # # ### ##### # # ### ### ### # ########### ########### ### ### ### # ### ####### # # # # ######### # ####### # ### # #
# # # # # #   # # # #   #     # # #   #   #   # #       # # #         #   # #       # #   #       # # # # #         # #       # #   # # #
# ### # ### # # ############# ##### ####### ########### # # # ######### ### # ############# # # # ######### # # ### ### #################
# #   #   # # #             #     #       #   # #     # # #                               # # # #   #   # # # #   #   #                 #
# ##### ##### # # ##### ### ### ############### # ####### # ##### ### ########### ##### # ### # # ### ### ############# # # ##### #######
#   #       # # #     #   #   #       # # # #                   # # #   #       #     # #   # # #   # #               # # #     #       #
# ##### # ##### # # # ### # ########### # # # ##### ####### ####### ##### ### ### ################### # ######### ######### # # ### # ###
# #     #   #   # # #   # #                       #       #                 #   #             # #               #         # # #   # #   #
# ##### ####### # ##### # # ######### # # # # ### ####### # # ####### ######################### # ### # # ### # ############# ### ### ###
# #           # #     # # #         # # # # #   #       # # #       #                               # # #   # #             #   #   #   #
# ### # # ##### # ### ### # ### # ### ### # # # ### # # ### # # # # # # ##### # ################# ##### ### ####### ############### # ###
# #   # #     # #   #   # #   # # #     # # # #   # # #   # # # # # # #     # #                 #     #   #     # #     #   #     # #   #
# ##### ######### ##### ### # ######### ##### ############# # ### ### # # # ################# # ########### ### # ##### # ### ####### # #
#   #       #         #   # #         #     #             # #   #   # # # #                 # #       #   #   #       #             # # #
# ##### ####### # ##### ### ### ### # ### # # # ######### ####### ### # # ########### ##### ########### ######### ######### # # ##### # #
# #         #   #     #   # # #   # #   # # # #         #       #   # # #           #     #                 # # # # # #   # # #     # # #
# ##### # # # # # # # # # # # ########### # ####### ### # ####### # # # # # # # # # ### # ####### # ##### ### # ### # # #################
# #     # # # # # # # # # #             # #       #   # #       # # # # # # # # # #   # # #     # #     #                 #       # # # #
# ### # # ##### ####### ##### # # ### ####### ### ### # ### # # # # # # # ####### # # # ### ### # ####### # ### ### # # # # ####### # # #
# #   # #   #         #     # # #   #       #   #   # #   # # # # # # # #       # # # #       # #       # #   #   # # # #               #
### ### # # # # ######### ### # # # # # ############# ### # ######### # # ### ######### # # ### # # ##### ########### # # ####### ##### #
#   #   # # # #         #   # # # # # #             #   # #         # # #   #         # # #   # # #     #           # # #       #     # #
# # ### ##### # ### ##### # ### # # ### ### # # ##### ### # ####### ### # # # # ### ### # ### ### # ### # # ### ####### # # # ### # # # #
# # #     #   #   #     # # #   # #   #   # # #     #   # #       #   # # # # #   #   # #   # # # #   # # #   #     #   # # #   # # # # #
# ### # ##### # # # # ####### # # # ### # # # # # ### ##### # ### # ##### ##### # ### ### # ### # # ### # ############### ######### #####
# #   #   #   # # # #     #   # # #   # # # # # #   #     # #   # #   #       # #   #   # #     # #   # #               #         #   # #
### ### ### # ##### # ######### # # ### # ### ### ### # ##### # ####### # # ##### ### ### # ############# # # ##### ##### # # ####### # #
#   #     # #     # #         # # # #   #   #   #   # # #   # #   # #   # #     #   #   # #           # # # #     #     # # #       #   #
# ##### ### # ####### ####### # # ########### ########### ##### ### ##### ####### ### ### ### # # ##### ##### # # # # # # # ######### ###
# #       # #     # #       # # # #         #                 #         #       #   #   #   # # #           # # # # # # # # # # #   #   #
# ### # ##### ### # # # ### # ### # ##### ##### ### ########### ### ### # # # ### # # # ### ### ### # ######### # ########### # # ##### #
# #   # #   #   #   # #   # # #         #     #   #           #   #   # # # #   # # # #   #   #   # #         # # #                   # #
# ##### ### # ##### ##### ### ### ####### ######### # # ### # ### # ##### # ########### ### ### # # # # ########### ######### ### # # # #
# #       #       #     # #   #         #         # # #   # #   # #     # #           #   #   # # # # #     #   # #         #   # # # # #
# # # # ### # ######### ####### # # ##### # # ### # ### ####### # # ####### # # # # ####### # # ### ### ##### ### # ##### ### ##### ### #
# # # #   # #         #       # # #   #   # #   # #   #       # # #       # # # # #       # # #   # #                   #   #     # #   #
# # ### # # # ########### ####### # ##### # ####### ### # # # # ##### # # # # # # # # # ### # # ### # # ### ####### # ### # ####### ### #
# # #   # # #           #   #     #     # #       #   # # # # #     # # # # # # # # # #   # # #   # # #   #       # # #   #       # #   #
# ### # ##### ####### ######### # # # # ### ##### # # # # # ### ### ######### ##### # # ### # # ####### # ### ####### ### ### # ####### #
# #   # #           #         # # # # #   #     # # # # # #   #   #         #     # # #   # # #     #   #   #       #   #   # #       # #
##### # # ### # # # # ########### # ### ### ####### ##### # # # ####### # # ### # ####### ########### # # ### ########### # # ######### #
#   # # # #   # # # #           # #   # #         #     # # # #       # # #   # #       #           # # #   #           # # #         # #
# # # # ### # ### # # # # # # ##### # # ### # # # ### ##### # ### ### # ##### ### # ### ######### ##### # # # # ####### # ######### #####
# #   #   # #   # # # # # # #     # # #   # # # #   # # # # #   #   # #     #   # #   # #       #     # # # # #       # #         #     #
### # # # # # # # # # ### # # # ### ### # # # ##### ### # # # # ### ####### ##### ##### # ### ##### # # # # ### ### # # ####### ### ### #
#   # # # # # # # # #   # # # #   #   # # # #     # # #   # # #   #       # #   # # # #     #     # # # # #   #   # # #       # # #   # #
####### # # # # # # # ####### # ##### # ##### ####### # ####### ############# ##### # ### # # ### # # # ### # # # ########### ### ##### #
#       # # # # # # #       # # # # # #   #                   #                         # # #   # # # # #   # # #           #         # #
# # ### ### # # # # # ######### # # ##### ### # ##### ####### # ####### # # ######### ####### ### # ####### # # ####### ### #############
# # #     # # # # # #       #           #   # #     #       # #       # # #         #       #   # #   #     # #       #   #             #
# # ### ### # ### # # ######### # # ##### ### # # ##### # ############# ### ####### # ##### # # # # # ##### ### ### # ###################
# # #     # #   # # #         # # #   #     # # #     # # #           #   #       # #     # # # # # #   # # # #   # #                   #
# ##### # ### # ### # ### # ### # ### ### # # ### ##### ### ### ##### ### # ### ### # ### ##### ####### # # # # ##### # ### # # # ### ###
# #     #   # #   # #   # #   # #   #   # # # #       #       #     #   # #   #   # #   #     #   # # # # #   #     # #   # # # #   #   #
# # # # # ### # # ### # # # # # # ### ### ### # # # # ##### ### # # ### ### ### ### # # ########### # ### # # ####### ####### # # # ### #
# # # # #   # # # #   # # # # # #   # # #   # # # # #   # #   # # #   #   #   #   # # #       # # # # #   # #       #       # # # #   # #
# ##### # # # # # ### # # # # # # ##### # # ### # ### ### ##### ########### ### ##### ### ##### # # # # ######### ### # # # # ### # # # #
# #     # # # # #   # # # # # # #       # # #   #   #         #           # # #     #   #     #                 #   # # # # #   # # # # #
##### # ##### ### ##### ### # # # ##### # ### # # # # # ######### ### ### ### # ############### ### ##### # ##### # ### # ### # # # #####
#     #   #     #     #   # # # #     # #   # # # # # #         #   #   #   # #             #   # #     # #     # #   # #   # # # #     #
# # # # ### # # # # ### ### # ### ### ### ####### # # ### ########### ####### ### ### ####### ### ##### # ########### ####### ###########
# # # #   # # # # #   #   # #   #   #   #   #     # #   #           # #     #   #   #       #         # #           #     # #   # # # # #
##### # ### # ##### # # ##### ### # ### # ##### # # # # # # ########### ##### ############# # ############### ########### # # ### # # # #
#     # #   #     # # #     # #   #   # # #     # # # # # #         #             #       #                 #       #   #   #           #
# ### # ### # # # # ### ######### # # ####### # # # # # # ### ##### # ### ### ##### ######### ################### # # ########### #######
# #   # #   # # # # #       #   # # #       # # # # # # #   #     #     #   #               #             # #   # #             #       #
# # # # # # # # # # ### # ### ### # ####### # # # # # # # # ##### # # # ####### ################# ######### # ####### ######### # # #####
# # # # # # # # # # #   #       # #       # # # # # # # # #     # # # #       #       #         #       #           #         # # #   # #
# # # # ### # # # ### # # # ### ### # # ### # # ####### # # # # # # # # ####### ### ### ############### # ######### # # # ##### # # ### #
# # # # #   # # #   # # # #   #   # # # #   # #       # # # # # # # # #       #   #                   #           # # # #     # # #     #
# # # ### # # # # # # # ### ####### ##### # # # ### # # ##### ######### # # # # # # # # ### # ########### ### ####### ##### # ### ### # #
# # # #   # # # # # # #   #       #     # # # #   # # #   #           # # # # # # # # #   # #           #   #       #     # # # #   # # #
# # # ##### # # # # # # # # # # # # ####### # # # # # # ### # # ######### # # # ##### ### # # # # # # ####### ### ############# ##### # #
# # # #     # # # # # # # # # # # #       # # # # # # # #   # #         # # # #     #   # # # # # # #       #   #                   # # #
# # # # # # # # # ### # ### # ### # ####### ### # # # ### ### # ### ####### # # # # ### ##### # # # # # # # ##### ##### # ######### #####
# # # # # # # # #   # #   # #   # #       #   # # # #   # #   #   #       # # # # #   #     # # # # # # # #     #     # #         #     #
# # # # # # ### # ### # ######### # # ######### # # # ### ### # ### ######### # # # # # # # ### ### # # # # ### # # ##### ####### #######
# # # # # #   # #   # #         # # #         # # # #   #   # #   #         # # # # # # # #   # #   # # # #   # # #     #       #       #
# # # ##### # ### ##### # # ### # # # # # ### # # ### ####### # ### # ### # # # # ### # # ### # ### ### ####### ####### ##### ##### # ###
# # # #     #   #   #   # #   # # # # # #   # # # #         # #   # #   # # # # #   # # #   # #   #   #       #       #     #     # # # #
# ### ### # # # # ### # # ##### ### # # ### # ##### # # # ### # # # # # ##### # ##### ### # ### # # # # ### ######### ####### ### ##### #
# #   #   # # # #   # # #     #   # # #   # #   # # # # #   # # # # # #     # #     #   # #   # # # # #   #         #       #   # #     #
# ### # ### # # ##### # # # ####### # # ### # ### ### # # ### # ### ### # # ### ######### # ### # # ### # # ####### # ##### ### ### #####
# #   # #   # #     # # # #     #   # #   # #       # # #   # #   #   # # # #           # #   # # #   # # #       # #     #   #         #
##### ### # # # ##### # # ##### ##### # # # # # ### # ### ##### ### ##### ##### # ##### # # ### # # ### # ####### # ####### # # # # #####
#       # # # #     # # #     #     # # # # # #   # #   #     #   #     #     # #     # # #   # # #   # #       # #       # # # # #     #
### # ### ### # # # # # # ### ##### # ### # # # ### # # ### ### ### ####### # # # # ##### # ####### # ### ### ### ########### ##### # ###
#   #   # #   # # # # # #   #     # # #   # # #   # # #   #   #   #       # # # # #     # #       # #   #   # # #         # #     # #   #
### # # # ##### # ##### # # # # # ####### # # # ### # # ### ### # # ############### ### # # # ##### # ### # ### ### ####### ### ##### # #
#   # # # #     #     # # # # # #       # # # #   # # #   #   # # #     # #       #   # # # #     # #   # #       #       #   #     # # #
# # # ### # # # # # ### # # # ############# # # # ### # ####### # # ##### # ####### # ####### # ##### ### # ########### # # #############
# # # #   # # # # #   # # # #             # # # #   # #       # # #             #   #       # #     # #   #           # #               #
##### # # # # # ### ##### ### # # ### ### ### ######### ##### ##### ##### # ##### # # # ### # # # ### # # # # # ##### # # ### # ### # ###
#     # # # # # # #   #   #   # #   #   #   #       #       #   #       # #     # # # #   # # # #   # # # # # #     # # #   # #   # #   #
### # # # # # # # # # ### ### # # ##### ### ### ### ### # # ### # # # ### # # ##### # # ####### # # # # # # # # # # ##### # ### # # #####
#   # # # # # # #   #   # #   # #     #   #   #   # #   # #   # # # #   # # #   # # # #       # # # # # # # # # # #     # #   # # #     #
##### # # # ### ### ### ### # # ##### ######### ##### # ##### ##### # # # # # ### # ### # # # # # # # # # # ### ##### # ### # ### # # ###
#     # # # #     #   # #   # #     #         #   # # #     #     # # # # # #     #   # # # # # # # # # # #   #     # #   # #   # # # # #
# # ### # # # # # # ### # # # # # # # # # ######### ### # # ### ### # # ##### # ##### ### # ##### ####### # ### # ##### ### # ##### # # #
# # #   # # # # # #   # # # # # # # # # #     #       # # #   #   # # #     # #     #   # #   #       # # # # # #     #   # #     # # # #
# # ### # # # # ### ##### # # # # ##### # # # # ####### ### # ##### # # # # # ### ####### # ##### # ### ### # ############### ######### #
# # #   # # # # #       # # # # #     # # # #         #   # #     # # # # # #   #     # # #     # #       # #               #         # #
# ### # # # # ### # # ### # # # # # ##### # # # # ##### # ### ####### # ### # ####### # ### ### # ##### ##### ##### ### ########### ### #
# # # # # # # # # # # # # # # # # #     # # # # #   #   #   # # # # # #   # #   #   # # # # # # #     #   #       #   #           #   # #
# # # # ### ### # # # # ####### ### ##### # ##### ##### # ### # # # ####### # ### ##### # ### ### ######### ### ### ####### ##### ##### #
# #   # #     #   # #         #   #     # #     #     # # #               # #                   #             #   #       #     #      x#
#########################################################################################################################################
