#########################################################################################################################################
#o                                  # # #                                                   # #       # #   # # # #                     #
# # # ############### ### # ######### # # ####### ##################### ### ################# # ####### # ### # # # #####################
# # #               #   # #                     #   #           #     #   #                 #     # #   #     #         #               #
# ### # ### # # # # # # # ##### ####### ### # ####### ##### ### # ### ##### ############### # ### # # ### ##### ##### ### ############# #
#   # #   # # # # # # # #     #     # #   # # # #         #   #     #     #               #     #   #               #       #         # #
# # # # # ### ### # ##### # ####### # ######### # ####################### ### ##### ################# ##### ####### ######### ### ### ###
# # # # #   #   # #     # #       #                                     #   #   # # # # #                 #       #             #   # # #
# # # # # # ##### ### ### ### ### ##### # ######### ##### # ##### ######### ##### ### # # ########### # ##### # # # # ################# #
# # # # # #     #   #   #   #   #     # #         #     # #     #         #                         # #     # # # # #               #   #
# # ##### # # # # # # # # # ##### ######### ########### ### # # # ### ################# ### # # ##### # ##### # # # # ### # ########### #
# #   #   # # # # # # # # #   #           # #         #   # # # #   # #   #           #   # # #     # #     # # # # #   # #             #
# # # # # # # # ### # ########### # ### # ### ####### # # ### ##### ### ### ### # ### ####### # ### # ######### ### # # ######### #######
# # # # # # # #   # #           # #   # #           # # #   #     #   #       # #   #       # #   # #         #   # # #         #       #
# # # ### # ### # # # ####### ### # ### ##### # ### # # # ##### ### ### ##### # # # # ############### ############### ########### #######
# # # # # # # # # # #       #   # #   # #   # #   # # # #     #   #         # # # # #               #             # #           #     # #
# # # # # ### ### ####### ### ####### ### ####### ##################### ### ### ### # ### # # # ########### ### # # # # ### ### # ##### #
# # # #         #       #   #       #           # #               #   #   #   #   # #   # # # #           #   # #   # #   #   # #     # #
# # # ### ######### # ####### # # # # # # # ### ### ### ########### ##### ############# # ### ########### ### ### # # ### ####### ##### #
# # # #           # #       # # # # # # # #   #       #                 #             # #   # #         # # #   # # #   #   #   # #   # #
# # ##### # # ##### ### ##### # # # # ### # # # # ### ### ### ### # # ### # ########### ####### ####### ### ### ####### ##### ##### ### #
# # #     # #     # # #     # # # # #   # # # # #   #   #   #   # # #   # #           #       #       #       #   #   #                 #
####### # # ######### ##### # # # # # # ##### ##### ##### # ### ########### ############### # # ######### ######### ################# # #
# #     # #               # # # # # # #     #     #   # # #   #           # # # # #     # # #           #           #   # #   # #   # # #
# ### # # # ######### ####### # # # # # ##### ### # # # # # # ##### # ####### # # # ##### ############# ### # # ##### ### # ### # #######
# #   # # #         #       # # # # # #     #   # # #   # # #     # #                                 #   # # #             #         # #
# # # # # # # # ### # # ######### # # # # ### ### ### # # ### # # # # # # ####### # # ################### ### # ######### ### ### # ### #
#   # # # # # #   # # #         # # # # #   #   #   # # #   # # # # # # #       # # #                   #   # #         #       # #     #
# # # # # # # # # ########### # # # ### # ### ####### # # # # ### # # # ### # ##### # ##### ##### # ################### ##### # ### ### #
# # # # # # # # #           # # # #   # #   #       # # # # #   # # # #   # #     # #     #     # #               # # #     # #   #   # #
# # # # # # # # ####### ##### ##### ### ### ### ##### # # ####### ### # # # # # ##### ##### ##### ############# # # # ##### ##### # # ###
# # # # # # # #       #     #     # #     #   #   # # # #     # #   # # # # # #     #   # #     #             # #         # #   # # #   #
# # ### # # # # ### ####### # # # ##### # ### ### # # ######### # ### ### ### ### ### # # # ######### ################### ### ######### #
# # #   # # # #   #       # # # #     # #   #   #   #           #   # #     #   #   # #   #     #   #                   #       #     # #
# # ### # ### # ####### # # ##### ### # # ### ### ############### ### ### ### # # # # ### # # ### ########### ################### #######
# # #   # # # #       # # #     #   # # #   #   #               #   #   #   # # # # #   # # #               #                           #
### # # # # # # ### ### ### ### # # # # # # # ##### # # ##### ### # ##### ##### # # # ### ####### ### ####### ### ### # ### # # ### #####
#   # # #   # #   #   #   #   # # # # # # # #     # # #     #   # #     #     # # # #   #       #   #       #   # # # #   # # #   #     #
# # # # # ##### # ##### ######### # # # ### # # ### ### ### ##### # # # ### ### # ### ### # # # ##### ############# ####### # # # # # ###
# # # # #     # #     #         # # # #   # # #   #   #   #     # # # #   #   # #   #   # # # #     #                     # # # # # # # #
# # ### # # # # ########### ### ### ### # ### ######### # ####### ### ### # ##### # ##### # # ####### # # # ############### ### # # ### #
# # #   # # # #           #   #   #   # #   #         # #       #   #   # #     # #     # # #       # # # #               #   # # #     #
# ##### # # # # ########### # ##### ### ### # # # ##### # # # ### # # ############# # # ##### ### ##### ### # ##### ####### # # # #######
# #     # # # #           # #     #   #   # # # # # # # # # #   # # #             # # #     #   #     #   # #     #       # # # #       #
### ### # # ### # # ####### # ##### ### ##### # # # # ### # ### # ### # # ### ##### # # # ##### ##### # ### # ### # ############# #######
#   #   # #   # # #       # #     #   #     # # #       # #   # #   # # #   #     # # # #     #     # #   # #   # #           # #       #
##### # # # ##### # # ######### # ####### ####### # ### ### # # ##### # # # # # # # # # ### # ################# # # ########### # # # # #
#     # # #     # # #         # #       #       # #   #   # # #     # # # # # # # # # #   # #                 # # #             # # # # #
##### # # # ##### # # # ####### # ### # # # # # # # ##### # # # # # # # # ### ### # ### # # ### ### ### ######### # ##### # # ### # # # #
#     # # #     # # # #       # #   # # # # # # # #     # # # # # # # # #   #   # #   # # #   #   #   #         # #     # # #   # # # # #
##### ##### ### # # # ########### # # # ### # ##### # # ### ##### ##### # # ####### # # ### # # # ### ### ######### ##### # # ##### # # #
#       #     # # # #           # # # #   # #     # # #   #     #   #   # #       # # #   # # # #   #   #         #     # # #     # # # #
# ### # # # ##### # ##### ### ### ##### # ##### # # # ######### # # ### # # # ### # ### ##### # # # # # # # ### # # ######### # # # ### #
# #   # # #     # #     #   #   #     # #     # # # #         # # # # # # # #   # #   #     # # # # # # # #   # # #         # # # #   # #
# ### # ### # ### # ### # ####### ####### # # # # # # ### ### ##### # # ### # # ### ### # ### # # ### # # # # # # ##################### #
# #   # #   #   # #   # #       #       # # # # # # #   #   #     #   #   # # #   #   # #   # # #   # # # # # # #       #   #     # # # #
# # # # # # # ##### ### ######### ######### # ##### ##### ############### ### # ### ### ### # ### # # # # # ####### ##### ### ##### # ###
# # # # # # #     #   #         #         # #     # #   #   #       #   #   # #   #   #   # #   # # # # # # #     #   # #             # #
# # # # # ### ##### # # # # ##### # ### ### # ####### ####### ####### ##### ##### # # # ######### ### # # # # ######### # ####### # # # #
# # # # # #       # # # # #     # #   #   # #             #               #     # # # #         #   # # # #           #         # # #   #
### # # ### # # ### ### ####### # # ### ### # # ####### ### ########### ######### # # # # ### ##### ####### ####### ### ####### ### # ###
#   # #   # # #   #   #       # # #   #   # # #       #     #   # #   #         # # # # #   #   # #       #       #           #   # #   #
# ### # # # # # ### ### ##### ################### # # # ##### ### # ####### # # ##### # # ### # # ############# # # # # # ##### # # ### #
# #   # # # # #   # #       #                   # # # #                   # # #     # # #   # #               # # # # # #     # # #   # #
##### # # # # # # # ### # # ### ##### ####### ### # # ### # ### # # # # # ##### ##### # # # # # # # ####### # # ### ### # # # # ### # # #
#     # # # # # # # #   # #   #     #       #   # # #   # #   # # # # # #     #     # # # # # # # #       # # #   #   # # # # #   # # # #
##### # # ### # # ##### ############### # ### ### ### # # # # # ### ######### ### # ##### # ### # ### # # # # # # ### ##### # # # ### # #
#     # # #   # # #           # # #   # #   #   #   # # # # # #   #         #   # #     # #   # #   # # # # # # #   #   #   # # #   # # #
##### # # ### # # # ### # ##### # # ##### # # ##### # # ### # # ##### # # ########### ### ### ### # # # ########### # # ### # # # # # # #
#     # # #   # # # #   #               # # # #   # # #   # # #     # # #           #   #   #   # # # #           # # #   # # # # # # # #
##### ### # # # # # # # # # # # ### ### # # # # ##### # # # # # # # ##### ################# ### ### # # # ######### # # # # # ### # # ###
#       # # # # # # # # # # # #   #   # # # #       # # # # # # # #     #         #       #   #   # # # #         # # # # # #   # # #   #
##### ### # # # ### ### # # # ### ##### # # ####### # # # # # # ### # ### # ### ### ######### ##### # # ##### # # ### # # # ####### # ###
#       # # # #   # #   # # #   #     # # #       # # # # # # #   # #   # #   #             #     # # #     # # #   # # # # #     # #   #
# # # ### # # # ####### # # ####### ### # # # ######### # # # # # # ##### # # # # ### ########### ##### # # # ### ######### # ######### #
# # #   # # # #   #     # #       #   # # # #         # # # # # # #     # # # # #   #           #     # # # #   #         #           # #
# # # # ### # # ### # # # # # # # # # ### # ### ### # ### # ### # # ### # # # ### # # # # # # ##### # # # # ### # # ########### ####### #
# # # #   # # #   # # # # # # # # # #   # #   #   # #   # #   # # #   # # # #   # # # # # # #     # # # # #   # # #           #       # #
# # # # ##### # ### # ### # # # ### ##### # # ####### # ####### ### ### ### # # # ##### # # # ### # ### ### # # # # ##### ### # # ##### #
# # # #     # #   # # #   # # #   #     # # #       # #       #   #   #   # # # #     # # # #   # # #     # # # # #     #   # # #     # #
# # ### # # # # # ### ### # ### ### # ######### # ### ####### ##### ####### # # # # ######### # ### ### # ####### # # ### ##### ##### # #
# # #   # # # # # #     # #   #   # #         # #   #       #     #       # # # # #         # #   #   # #       # # #   #     #     # # #
##### # ### # # # ### # # # ### ### # # ### # # # # ### ### # ##### ######### ######### # # ### # # # # # # # ### # # ### # # # #########
# #   #   # # # # #   # # #   #   # # #   # # # # #   #   # #     # #   # #           # # #   # # # # # # # #   # # #   # # # #         #
# # # # # # # ### ### # # # # # ####### # ### # # # # ####### ### ### ### ##### # ####### ##### ### ### ### ##### # # ### ##### # # #####
#   # # # # # #   #   # # # # #       # #   # # # # #       # # # #           # #       #     #   #   #   # #   # # #   #     # # #   # #
### # # ### # ### # # # # # # ####### # ### ##### # ####### ### ### ##### ##### # ####### ##### ####### ##### ##### ####### # # # ### # #
#   # #   # # #   # # # # # #       # #   #   # # # # #   #           # #     # #       #   # # #   # #     #     #       # # # #   #   #
### # # ######### # ### # ### # ######### ##### ##### # ####### ####### ### # # # # # ##### # ### ### # # ### ### # # ### ### # # # #####
#   # #       #   #   # #   # #         #                     #           # # # # # #     #   #       # #       # # #   #   # # # #     #
### # # ##### # # # # # # ### ### ########### ### ### ### # # ####### # ### ### # # # ######### ### ### # ##### ### ### # ##### # # # ###
#   # #     # # # # # # #   #   #           #   #   #   # # #       # #   #   # # # #             #   # #     #   #   # #     # # # # # #
# ### # # ####### # ##### ### ### ### ##### # # # # # ### ##### # # # # # # ##### # # ##### # # # ####### # ### # ######### ####### ### #
# #   # #     #   #   #   #     #   #     # # # # # #   #     # # # # # # #     # # #     # # # #       # #   # #         #       #     #
##### # # ### # # # ##### # # ### ##### ##### ### # # ######### # # # ### ##### # # ##### # # # ######### ####### ### ### ##### ##### ###
# #   # #   # # # #   #   # #   #     #     #   # # #         # # # #   #     # # #     # # # #       #         #   #   #     #     #   #
# # # # ######### # # ##### # ### # # ######### # # # ##### ########### # # # ### ### # # # # # # ### # # # # ##### # ### # ### #########
#   # #       #   # # #     # #   # #         # # # #     #           # # # #   #   # # # # # # #   # # # # #     # #   # #   #       # #
# ### # ######### # # ### # # ### # # # ##### # ##### # # ### # ######### # # ### # ### # ##### # ##### # # # ####### ####### ######### #
# # # #         # # #   # # #   # # # #     # #     # # #   # #         # # #   # #   # #     # #     # # # #     #     #   #     # # # #
### # # # # ##### # ##### # # ### ##### # ############### # # # ####### ### # # # # # # # # ##### # ### ### # ##### # # # ######### # # #
# #   # # #   #   #     # # #   #     # #               # # # #       #   # # # # # # # # #     # #   #   # #     # # #           #     #
# # # # # # # ### # # ##### # ### ### ### # ##### # # ### ####### ##### ### # # # # ### ######### # ### ##### ####### # # ##### ### #####
#   # # # # # #   # # #     #   #   #   # #     # # #   #   #   #     #   # # # # #   # #       # #   #     #       # # #     #         #
# # # # # # ##### ### ### # # # # # ##### # ####### ### ##### ########################### ##### ### ### # # # # # # # ### # # # # ### ###
# # # # # #     #   #   # # # # # #     # #     #     # #               # #       #           #   #   # # # # # # # #   # # # # #   #   #
# # ##### # ### # # ##### ### ### # # # # # # # ### # # # ### # # ### ### # ####### ########### ####### # # ### # ### # # # # ### # ### #
# #     # #   # # #   # # #     # # # # # # # #   # # #     # # #   #     #                 # #       # # #   # #   # # # # #   # #   # #
# # ##### # # # # # # # # # # # ##### # # ######### ##### # # ### # # # ### ######### ####### ##### ### # # ##### # # # # ##### ### # # #
# #     # # # # # # # #   # # #   #   # #         #     # # #   # # # #             #     #       #   # # #     # # # # #     #   # # # #
# # # # ##### ### # # ##### # ##### # ### # ####### # # # ####### # # # # # # ### # ####### ############### # ### # ### # ### # ### ### #
# # # #     #   # # # #     #     # #   # #       # # # #       # # # # # # #   # #                       # #   # #   # #   # #   #   # #
### # # ### ##### # ##### # ### # ### # ####### ### # # # ### # # # # # ############# # ### ##### ##### # # ### # # ### # # # # # ##### #
#   # #   #     # #   #   #   # # #   #       #   # # # #   # # # # # #             # #   #     #     # # #   # # # #   # # # # #     # #
### # # # ### ### # # # # # # ####### # ### # # ### ####### ### ####### # # # # # ######### # # ##### ### # # ### # ### # # # # ### ### #
#   # # #   #   # # # # # # #   #     #   # # # # #       #   #       # # # # # #         # # #     #   # # #   # #   # # # # #   #   # #
# # # # # # # # ##### ### # # ### ### # ####### # ##### ### # # ### # # # # ### # ##### # ### ######### ### # ### # # # # # ### # # #####
# # # # # # # #     # #   # #   # #   #       #       #   # # #   # # # # #   # #     # #   #         #   # #   # # # # # #   # # #     #
# # # ### # # # ##### ### # # # # # # # # ### # # # ### ### ### # # # # ### # ##### ### ##### # ### ####### ##### # ######### # ### # # #
# # # #   # # #     # #   # # # # # # # # # # # # #   # # #   # # # # #   # #     #   #     # #   #       #   #   #         # # # # # # #
# # ##### # # # ### ##### # # # # ##### # # ### ### ### # # # ### ##### ### # ### # ### # # # # ### ### ########### ### # # ### # # #####
# #   #   # # #   # # #   # # # # #     #     #   #   #   # #   #     #   # #   # #   # # # # # #     #     #     #   # # # # # # # # # #
# # # ### # # ####### # # # # ##### # # # # # # # ### ########### ### # ##### # # ##### ### ### ### # ####### ### # ##### ### ### ### # #
# # #   # # #       #   # # #     # # # # # # # #   #           #   # #     # # #     #   #   #   # #           # #   # #   #   # #     #
# # # ### ### # ##### ### # # # # ### # # ### ### ######### # ### ### # # # # ### # # ### ############################# ##### ### # #####
# # #   # #   #   #   #   # # # # #   # # #     #         # #   #   # # # # # # # # #   #                           # # #     #         #
# ### ### # # # ##### # # # # # # # # # # # # # ### # ##### ### # # # # # # # # # # # ########### ####### ##### ##### # # ##### #########
#   #   # # # #     # # # # # # # # # # # # # #   # #   # #   # # # # # # # #   # # #   #   # # #     # #     #     # # #     #   # #   #
# ### # # # # # ### # # ### ### # # # # # # # # ### ##### ####### ############### # # # # ### # ####### ############# # # ##### ### # ###
# #   # # # # #   # # #   # #   # # # # # # # #   #             #   #           # # # #                             #   #     #         #
# # # ### # # # ####### ### ### ### # # # ### ##### ######### ### # # ######### # # # ####### ### # ### # ########### ### ##### ### #####
# # # #   # # #     #     # #     # # # #   #     #         # # # #   #       # # # #       #   # #   # #       # #     #   #     #     #
# # # ### # ### # # # # ### # # ### # # # ### ####### # ### ### ####### ############### # ### # # # ##### ##### # # ##### ### ### ### ###
# # #   # #   # # # # #   # # #   # # # # # #       # #   #   # # #   #               # #   # # # #     #   # #   # #     # #   # # # # #
##### ### # ### # ##### ####### ### ### # # # # ####### # ##### # # ### ############# ####### ####### ####### ##### # ##### # ##### ### #
#     #   # #   #     #     #     #   # # #   #       # #                           #       #       #                                  x#
#########################################################################################################################################
