#########################################################################################################################################
#o          #                     # #   #             # #     #                                     # #   #       #         #           #
# ########### ################# # # # ### ############# # ##### ### ######### ####### ############### # ### ####### ######### ###########
#                             # # #                 # # #   #     #         #   #   #               #             #   #   # #           #
# ### # # ####### # ############### ####### ######### # # ### ################### ##### ############# ##### ####### ### ### # ### # ### #
#   # # #       # #       #               #       #   #                 #             #                   #               # #   # #   # #
# # ### # # # # # ######### ####### ##### ####### # ### ######### # ##### ##### ############### ##### # ######### ####### # # ##### #####
# #   # # # # # #       #   #     #     #       #               # # #         #               # #   # #         #       #         #     #
# ### ######### # ### # # ### ####### # ### ##### ### # # ### # # ### ### ####### # ##### ### ### ### ### # ################### # # # ###
#   #       #   #   # #             # #   #     #   # # # # # # #       #       # #     #   # # # # #   # #       #   #       # # # # # #
# ### # ####### # ##### # # # ### ########### ######### ### ### ######### ### ##### # ### ##### # # ############### ### ####### ####### #
#   # #       # #     # # # #   #       #   #         #     # #   #     #   #     # #   #     #                               #         #
# # # # # ##### # ##### ### # # # ### # # ######### # ##### # ##### ################### ####### ### ########### # ####### # # ###########
# # # # #     # #     #   # # # #   # #           # #     # # # # #       # #         #           #     #     # #       # # #           #
# # ### ### # # # # # # ######### ################# ######### # # # ####### # ##################### ##### ########### ### # ########### #
# #   #   # # # # # # #         #               # # # # # #   #                       #           #           #     #   # #           # #
# # # # # # ### # # # # # ### # ##### # ### ### # ### # # ### # ### ### ############### ######### ### # ### ### ####### #################
# # # # # # #   # # # # #   # # #   # #   #   # #         # #     #   #       #                 #   # #   #           #   #           # #
# # # # ### # # # ### # ### # # # ####### ####### ### ##### # ### ############# ######### # # ### ##### # ##### ######### # ### ### ### #
# # # #   # # # #   # #   # # #     #   #           #           #                       # # #   #   #   #     #         #     #   #     #
# # ### ### ### # ### # ##### # # ### ##### # # # # ### ### # ### # # # # # # ### # # # ### # ##### ##### ### # # ### # ### ### # # # # #
# #   #   # #   #   # #   #   # #         # # # # #   #   # # # # # # # # # #   # # # #   # #     #     #   # # #   # #   #   # # # # # #
# # # # # ### # # # ####### # # # ### # ### # ### # ### # # # # ######### # ### # ##### # # # ########### # ##### # ### # ##### #########
# # # # #   # # # #       # # # #   # #   # #   # #   # # # #           # #   # #     # # # #           # #   # # #   # #     #         #
### ##### ####### # ##### ### # # ### ############# ####### ####### # # # # # ##### # ######### ### ### # ##### ### ##### ### # # # #####
#       #       # #     #   # # #   #           # #       #       # # # # # #     # #         #   #   # #         #     #   # # # #     #
# # # # # # ##### # ### # ### # # # # ########### ######### # # # ####### ####### ########### # # # # ##### ### ### ### ### ### # # #####
# # # # # #     # #   # #   # # # # #       #     #       # # # # # # # #       #           # # # # #     #   #   #   #   #   # # #   # #
# # # # ##### ##### ##### ### ### # ### ##### ##### ####### ### ### # # ### # ##### ##### ##### # # ############### ### # # ##### ##### #
# # # #     #   #       #   #   # #   #                   #   #   #       # #     #     # #   # # #               #   # # #     #     # #
### ### # # # # # # # # # # # # # ### ######### # ### ####### # ### ##### ### ######### ### ########### # # # ##### ####### ########### #
#     # # # # # # # # # # # # # #   #         # #   #       # # #     # #   #         # # #           # # # #     #       #     #   # # #
### # # # # # # # # # ####### # # ####### # ### ### # # # # ### # ##### ############# # # # ########### ############# ########### ### # #
#   # # # # # # # # #       # # #       # #   #   # # # # #   #                 #   # #       #   #   #     # #     # #               # #
# # # # # # ####### ### # # # ### ####### # ### # # ### # # # # ##### # ##### # # ############# ### ####### # # ### ### ########### ### #
# # # # # #     #     # # # # #         # #   # # #   # # # # #     # #     # #                           #       # # #           #   # #
# # ##### # ##### # # # # ##### # ##### # # # # # # # ### # # # # # ### ##### # # # # ##### ############### ######### # ############### #
# #     # #     # # # # #     # #     # # # # # # # #   # # # # # #   #     # # # # #     #   #           # #               #     # # # #
# # ##### # ### ### # # # # ### # ######### # # # ####### ##### # # # # # ### # ##### ### ##### ############# ##### ##### ### ### # # # #
# #     # #   # #   # # # # #   #         # # # #   #   #     # # # # # #   # #     #   # #                       #     #     # # # # # #
# # ### ### ### # # ### ### ### # # # # # # # # ### # ######### ### ##### # # ### # ### ### ##### ####### # ####### # ######### ### # # #
# #   # # #   # # #   # #     # # # # # # # # #   #           #   #   # # # #   # #   #         #       # #       # #     #     #       #
# # ##### # ### ### # ### # # # # # ### # ##################### ### # # ##### # # ### # # # # ############### # # # ####### ### # ### ###
# #       #   #   # #   # # # # # #   # # # # #   #           #   # #       # # #   # # # # #               # # # #           #     #   #
# # ### ### # # ### # ### # ##### # ####### # # ### ########### # ##### ##### # ### # ### # # # # ### ### ####### # # # # # ### # # # # #
# #   #   # # #   # #   # #   #   #                           # #     #     # #   # #   # # # # #   #   #       # # # # # #   # # # # # #
# # ##### ############# # # # ### ########### # # # # # # # ### # # ### # ##### ##### ### # ### # # ### ########### ### # # # # # #######
# #     #             # # # #   #           # # # # # # # # #   # #   # #     #     # #   #   # # #   #           #   # # # # # #       #
# # # ################# ### # ### # ### # ####### ### ##### ### ### ### ####### ### # ### # ### # # ### ########### ##### # ##### #######
# # #                 # #   # #   #   # #       #   #     #   # # #   #       #   # #   # #   # # #   #           #   #   #   #         #
# # # ### ##### ############# ### ### ### # ##### # # # ### # # # # ### ### ##### ####### ##### # # ##### ######### ### # # # # # # # ###
# # #   #     #             # #     #   # #     # # # #   # # #   #   #   #     #       #     # # #     #         #   # # # # # # # # # #
# ### # # # ##### # # ########### ### # # # # ### # ### # ### ### # # # ### # # # ### ### # ### # # ##### ### ### # # # # # ##### ##### #
# #   # # #     # # #           #   # # # # #   # # #   #   #   # # # #   # # # #   #   # #   # # #     #   #   # # # # # #   #         #
# ### # # # ##### # # ### ### ### ####### # # # # # ### # # ### # ### # # # # ### ### # # # # # # # # ##### ### ####### ### # ### ### # #
#   # # # #     # # #   #   #   #       # # # # # #   # # #   # #   # # # # #   #   # # # # # # # # #     #   # #   #     # # #     # # #
# ### ### # # # ##### # # ####### # # ### # # # # # # # ### ### ### # # ##### # # ####### ### ### # # ##### # ### ##### ### ##### # #####
#   #   # # # #     # # #     # # # # # # # # # # # # #   #   #   # # #     # # #       #   #   # # #     # #         #   #     # #     #
# ### ####### # ##### # # ##### # ##### # ##### ### # # ### ### ##### ####### # # ### ### ####### # # ####### ##### ##### # ##### # #####
# #       #   #     # # #       #       #     # #   # #   #   #     #       # # #   #   #       # # #       #     #     # #     # #     #
# # # # ##### # # # ############# ### ##### ### ### ### # # # ### ### # ### ### ##### ### ######### # ### # # # ##### ######### # ### # #
# # # #   #   # # #     #     # #   #     #   # # #   # # # #   #   # #   #   #     #   #         # #   # # # #     #         # #   # # #
# # # # # ### # # ####### ##### ##### ##### ##### ### # ##### ### # # # # ##### ##### ####### # # # # # # ### # # ### ##### ### # # # # #
# # # # #   # # #                   #     #         # #     #   # # # # #     #     #       # # # # # # #   # # #   #     #   # # # # # #
### # # ######### # ### ####### ##### ######################### # ####### ### # ##### # # # # ##### # # ### # # # # # ### # # # # # # # #
#   # #         # #   #       #     #         # # # #         # #       #   # #     # # # # #     # # #   # # # # # #   # # # # # # # # #
### # # # ### ##### # # ##### ### ### # ####### # # # ### ##### # ### ### # ### # # # # # # ####### # # # ### ##### ##### ####### ### # #
#   # # #   #   #   # #     #   #   # #                 #     # #   #   # #   # # # # # # #       # # # #   #     #   # #       # #   # #
# # # # ##### ### # # # ####### ################# # # # # # ### # # ##### ####### ### # ##### ##### # # # # ##### ##### ######### ##### #
# # # #     #   # # # #       #                 # # # # # #   # # #     #       #   # #     #     # # # # #     #               #     # #
# ##### # # ### ### ### # # ############# # # ### ### ##### # # # ### ################# ####### ################# # ################### #
# #     # #   #   #   # # #             # # #   #   #     # # # #   #                 #       #                 # #                   # #
##### # ##### # # # ### ### # # # # # # ### ### # ####### ### # # ### ### ### ##### ############# # ### # ####################### # ### #
#     #     # # # # #     # # # # # # #   #   # #       # # # # #   # # #   #     #             # #   # #                       # #   # #
### # # ### # # # # # # # # # ### # ### ### # # ### # ### # ########### ############# ### ### # # ### # ##### ######### ####### # #######
#   # #   # # # # # # # # # # #   # # #   # # #   # #   #             #   # #       #   #   # # #   # #     #         #       # #       #
# ### # # # ### ### # # # # ##### # # ### ### ##### ####### # ######### ### # ####### ##### # # # # # # # # ####### ####### # ##### #####
# #   # # #   #   # # # # #   #   #     #   #     #       # #                       #     # # # # # # # # #       #       # #     #     #
##### # ######### # # # # ### ### # # ##### # # ### ######### ### ### # ### # ####### ############### ### # ### # ### ####### ###########
#     #         # # # # #   # #   # #     # # #   #         #   #   # #   # #       #         # # # #   # #   # #   #       #           #
### # # ############# # # ### # # # # # ##### # # # # ######### # ######### # # ### ####### # # # # ####### ##### ### ### ########### # #
#   # #             # # #   # # # # # #     # # # # #         # #         # # #   #       # #             #     #   #   #   #       # # #
##### # # # # # # ### # ##### # # # # # ### # # ### # # ####### # ##### ##### # # ### ### ######################### ######### ####### # #
#     # # # # # #   # #     # # # # # #   # # #   # # #       # #     #     # # #   #   #                         #                 # # #
# ### # # ####### # # # # ####### # # # # ##### # # ### ### # # # ### # # ### # # # # ##### ### ### ### # # ####### # ##### ##### # # ###
# #   # #     # # # # # #       # # # # #     # # #   #   # # # #   # # #   # # # # #     #   #   #   # # #       # #     #     # # # # #
# # # # # # ### ####### # # # ##### # ######### ### # # # # # ##### ##### ### ### # # # # ##### # ##### ### ##### ##### ##### ######### #
# # # # # #           # # # # #     #         #   # # # # # #     #     #   #   # # # # #     # #     #   #     #     #     #     # #   #
# # # ### # ####### ##### ### ### # # # ####### ### # # ### ##### # ##### ### ##### # # # ### # # ####### # # # ### # ############# # ###
# # # #   #     # #     #   # #   # # #       #   # # #   #     # #     #   #     # # # #   # # #       # # # #   # #     #   # #       #
### # # # # ### # ##### # # # # # # # ### ##### ##### ############# # # ####### ### # ### # ### # ############# ####### ### ### # ### ###
#   # # # #   #       # # # # # # # #   #     #     #             # # #       #   # #   # #   # #           #         #     #       #   #
### ### ### # # ### # # # ### # # # # # # ### ### ### # ### ### ### # # # # ### # # # # # # ### # ####### ##### # ######### # ##### # # #
#   #   #   # #   # # # #   # # # # # # #   #   #   # #   #   #   # # # # #   # # # # # # #   # #       #     # #         #       # # # #
### ####### ##### # # ### ##### # # # # ##### # # ### # ### ### # ### ### # # ### # # ### # # ### # ### ####### # ### # ### # ### ##### #
#     #         # # #   #     # # # # #     # # #   # #   #   # #   #   # # #   # # #   # # #   # #   #       # #   # #   # #   #     # #
# # # ##### # # # ### ######### # # # # ### ### # # ### # ####### # # # # # # # # # # # # # # # # # ### # ##### ### ######### # # ##### #
# # # #     # # #   # # #     # # # # #   #   # # # #   #       # # # # # # # # # # # # # # # # # #   # #     #   #   # #   # # #     # #
# # # # # # # # ####### # ##### # # # # # ######### ### # # # # ####### ####### # # # # # # # # ### # # # # # # # ##### # ###############
# # # # # # # #               # # # # # #         #   # # # # #     # #       # # # # # # # # #   # # # # # # # #     #               # #
# # # ##### # # # # # # ### ##### # # # # # # # # # ####### # # # # # # # ########### ##### ### ### # # # # # ######### ##### ######### #
# # #   #   # # # # # #   #     # # # # # # # # # #       # # # # #   # #         # #     #   #   # # # # # #               #           #
# # # # ### ### ### # ### # # # ### ### # ####### # # # # ######### # ### # ### # # # # # ### # # ### # # # # # # # # ##### # # ### ### #
# # # # #     # # # #   # # # #   #   # #       # # # # #         # # # # #   # #   # # #   # # #   # # # # # # # # #     # # #   #   # #
# # ### # # ### # # # ####### # ### ##### ##### # # ### # ### # ##### # ### # # ################### # # # # # # # # # # # ### ##### # # #
# # #   # # #     # #       # #   #     #     # # #   # #   # #     #     # # #       # #         # # # # # # # # # # # #   #     # # # #
# # # # # # # # ### # ############# ##### ######### # # # # # # # ##### ### ##### ##### # ### ### # # ### # # ##### # ### ##### ##### # #
# # # # # # # #   # #   #       #       #         # # # # # # # #     #   #     #           #   # # #   # # #     # #   #     #     # # #
# # # # # # ### # # # ### ####### # # # # # # ##### # # ####### # # ### ######### ### ### # # # # ##### ##### # ### # ### # # ##### ### #
# # # # # # #   # # #           # # # # # # #     # # #       # # # # # # #     #   #   # # # # #     # #   # #   # # #   # #     #   # #
# # ##### # ### # # # ##### # # ### ### ### # # ####### # ########### ### # ########### ### # # # ####### ### # ##### # # # # # # # ### #
# # #     #   # # # #     # # # #     #   # # # #     # # # # # #                     #   # # # #           # #     # # # # # # # # # # #
# # # # ### ### # ##### ####### # # # # ### # ### ##### ### # # # ##### ### # ######### # # ######### ### ### ### ####### ##### ### # # #
# # # # #     # #     #       # # # # #   # #       #                 #   # #         # # #         #   #   #   #   # #       #   #   # #
# # # # ### ### # ### ######### ### # # ### # # ### ### # ####### # ### ### # ########### # # ### # # # ##### # ##### ### # # # ### #####
# # # # #     # #   #         #   # # #   # # #   # #   #       # #   #   # #           # # #   # # # #     # #         # # # #   #     #
# # ##### # ### # ### # ####### ##### # # # # ##### ### # ##### ##### # # # # ##### ### ################# ### # ##### ##### # ##### # # #
# # #     # # # #   # #     # #     # # # # #   # #   # #     #     # # # # #     #   #                 # #   #     #     # #   # # # # #
# ##### # # # # ##### # # ### # # # # # # # # ### ##### # # ### # # # # # # # # # ### ####### ### # ##### # # # # ##### ##### # # ### ###
# #     # #   #   #   # #     # # # # # # # #         # # #   # # # # # # # # # #   #       #   # #     # # # # #     #     # # #   #   #
# ######### ### ##### # ############# ### # # ##### ####### ### # ### # # ### ### # ##### ### # # # # ##### ### # # # ### # ### # ##### #
# #   #       # #   # #             #   # # #     #   #       # #   # # #   # #   #     #   # # # # #     # #   # # #   # #   #       # #
# # # # ### ### # ### ##### ### ##### # # # # ### ### ##### # ########### # ##### ####### # # # # # # ### ### # # # ############### # # #
# # #   #     #     #     #   #     # # # # #   #   #   # # #           # #   #         # # # # # # #   #   # # # #     #         # # # #
### # ##### ### # # # # ######### ### # # # # # # ### ### # ############# # # ### ##### # # ### ##### ### # ### ### ##### ##### # # #####
#   # #       # # # # #         #   # # # # # # #   #   #     #         # # # #       # # #   #     #   # #   #   #           # # #     #
######### # ### # # # # ### ##### ##### ### # ### # ######### # ### # ##### # # # ##### # # # # # # # ### ######### ### # # # # # #######
#         #   # # # # #   #   # #     #   # # #   #         #     # #   # # # # #     # # # # # # # #   #         #   # # # # # #     # #
##### # # # # ### # ### ####### ####### ### # ### # # # ### # # ##### # # ####### # ##### ### ### # # # ### # ##### # ##### # ######### #
#     # # # #   # # #                 #   # #   # # # #   # # #     # #       #   #     #   #   # # # #   # #     # #   # # #       #   #
### # # # # # # ### # # # # # ########### # # # # ##### ### # # ##### ##### # ### ####### ### ##### # # ### # # ### ### # # # ### # ### #
#   # # # # # #   # # # # # #           # # # # #     #   # # #     #     # #   #       #   #     # # #   # # #   #   #   # #   # # #   #
# ### # ### ### ##### # # ### # # ##### ##### ### ### ### # # # # ### # ### # ### # ##### # ######### # # ######### ####### ### ####### #
# #   # #     #   #   # #   # # #     #   #     #   #   # # # # #   # #   # #   # #     # #         # # #       #         #   # # # # # #
##### ##### # ####### # # ### # ############# # ############# # # # ####### # # ######### # ### ### ### ####### ### ########### # # # # #
#       #   #   #     # # #   #         #     #             # # # #       # # #         # #   #   # #         # #             #        x#
#########################################################################################################################################
