#########################################################################################################################################
#o                                                #                         # # #     #       #       #     #   #   # #           # #   #
# ######### ##### ### ################# # ### ##### ##### ####### ######### # # # ##### ####### ####### ##### ### ### # ######### # # ###
#         #     #   #                 # #   #           #     # #   #     #               #             #   #       #   #       # #     #
# # # # # ### ### ### # ####### # ####### ################### # ### # ########### ######### ############# ### ####### ### ####### # #####
# # # # #   #   #   # #       # #       # #   #             #     #             #   #               # #       #     #           #       #
# ### ### # ##### # # ####### ### # ####### ### ### ######### ####### # # # # ##### # ############### # ####### ##### ############### ###
#   #   # #     # # #       #   # #               #         #       # # # # #     #                                 #               # # #
# ### ##### # # # # # # # ### # # # # ##### # # ### ##### ########### ### ########### # ##### ### # ####### ### # ### ######### # ##### #
#   #   #   # # # # # # #   # # # # #     # # #   #     # # #     # #   #           # #     #   # #       #   # #       #   # # #     # #
# ### # # # # # # # ##### ### ##### # # ####### ### # # # # # ### # ####### # ########### ##### # # ### ##### # # ####### ### ######### #
#   # # # # # # # #     #   #     # # #       #   # # # #       #         # #           #     # # #   #     # # #                     # #
# # # ### # # ### # ### # # # # ##### ### ### # # # # # # # # # # # # # ### ### # # ### # ### ##### # # # ### ########### # # # ####### #
# # #   # # #   # #   # # # # #     #   #   # # # # # # # # # # # # # #   #   # # #   # #   #     # # # #   #           # # # #         #
# # # # # # # # ### # ####### # # ### # # ##### # ### # # # # # # ####################### # ############# # ####### ### # ### # ### # # #
# # # # # # # #   # #       # # #   # # #     # #   # # # # # # #                       # #             # #       #   # # #   #   # # # #
# ### # ### # # # ##### # ### # ##### # ####### # # ### ### # # # # # ##### ### # ### ##### # ### ##### ####### # # ##### # # # # ##### #
#   # #   # # # #     # #   # #     # #     #   # #   #   # # # # # #     #   # #   #   # # #   #     #       # # #     # # # # #   # # #
# # ####### # # # # ######### # ### ################# # # # ### ##### ################# # ##### # # # ### ##### ########### # # ##### # #
# #       # # # # #         # #   #                 # # # #   #     #     #           #       # # # #   #     # # #       # # #       # #
# ##### ####### ########### ### ####### # ############# # # ### # # # ##### ############# ### # ##### ### ####### # ##### ### # ### ### #
#     #       #           #   #       # #             # # #   # # # #                   #   # #     # #                 #   # #   #   # #
# # ### ### ### # # ##### # ####### ### # ##### # # ##################### # # ### # # # ##### # ### # # # # ### # # ### # # ### # # # ###
# #   #   #   # # #     # #       #   # #     # # #   #                 # # #   # # # #     # #   # # # # #   # # #   # # #   # # # #   #
# ### ### # ### # ##### ####### # # # ### # # ### ##### ####### ##### # # # ############# ##### # # # # ### # # ################# # # # #
#   #   # #   # #     #       # # # #   # # #   #             #     # # # #   #         #   # # # # # # #   # #                 # # # # #
# # ### ##### ### ### ### ### ### # ######### ### # ### ### # ### # ####### # # ##### ####### ####### ##### # # ### ##### ######### # # #
# #   #     #   #   #   #   #   # #         #   # #   #   # #   # #       # #       #               #   #   # #   #     #       # # # # #
# # ### # ### ### ### ### ### # # # ##### ### ### ####### ### ### ####### # # ######### # ############# ### # ####### # ######### #######
# #   # # #   #     #   #   # # # #     #   #   #       # # #   #       # # #         # #       # #   #   # #       # #                 #
# # # # ####### # # # ########### # # # # ### ##### ####### ######### ### ### # # ########### # # # ####### # # ##### ### ### # ##### # #
# # # #   #     # # #           # # # # #   #     #                 #   #   # # #           # #   #       # # #     #   #   # #     # # #
# # # # ##### # # ####### # # # ##### ####### # # ### # ### ### # # # ##### # # # ####### ### # ### ########### ########### ### ### # # #
# # # #     # # #       # # # #   #         # # #   # #   #   # # # #     # # # #       #   # # #     # #     # #         # #     # # # #
# ### # # # # ### ##### ######### # # ### # # # ####### # # # ####### # # ######### # # ##### ### ##### # ####### ####### ######### ### #
#   # # # # # #       #         # # #   # # # #       # # # #       # # #         # # #     # # #         #             #         # #   #
# # # # ### ### # # # ### # ######### ### # # # ### ### # ### ########### ##### # ##### ####### # ######### ################# ######### #
# # # #   #   # # # #   # #         #   # # # #   # #   #   # #         #     # #     #     #   #       # #                 #         # #
# ### ### # ### # # # ### # # # ##### ### # ### ### ####### # # ####### ### ##### ########### ### ### ### # ##### # ######### # ####### #
# # #   # #   # # # #   # # # #     #   # #   #   #     # # #     # # #   #     #   # #   #         #           # #         # #     # # #
# # # ############# # ### # # # # # # # ### ### # # # ### ######### # ############### # ### ####### ##################### ##### ### # ###
# #           #     #   # # # # # # # #   #   # # # #                         #   #               #                     #     #   #     #
# ### # ####### # # # ##### # # # # # # # # # # ### # # # # # ### ############# ### ####### # # # ####### # ######### ############# ### #
# #   #       # # # #     # # # # # # # # # # #   # # # # # #   #                 #       # # # #       # #   #     #             #   # #
# # # # ######### # # # ##### ##### ### # # ### # # # # # # # # # # # ##### ##### # ####### ##### # ### ### ### ### # ######### ##### # #
# # # #       #   # # #     #     #   # # #   # # # # # # # # # # # #     #     #         #     # #   #   #       # #         #     # # #
# # # # # ### # # # # # # # # ####### # # # # # # ### # # # # ### ####### # # ######### # ######### ### ####### ##### ##### # ###########
# # # # #   # # # # # # # # #   #   # # # # # # #   # # # # #   # #     # # #         # #         #   #       #     #     # #           #
# ### # # # # # # ### # # # ##### ####### ##### # # # # # # # ### # ### ##### ####### # # # # ##### ##### # ### # # # # ### ##### ### # #
#   # # # # # # #   # # # #             #     # # # # # # # # #       #     #       # # # # #     #     # #   # # # # #   #     #   # # #
# ### ### ####### # ### # # # ### # # ### # ### # # ### # # # # # # # ### # ######### # # ### ### # # # # # ### # ### # ### # ### # #####
#   #   #       # #   # # # #   # # #   # # #   # #   # # # # # # # #   # #         # # #   #   # # # # # #   # #   # #   # #   # #     #
# ### ### ### ### # ##### ####### ### ### # ### # ##### # ### # # # ##### ######### ### # # # # ######### # ##### # # # # # # ### # # # #
#   # #     #   # #   #         #   #   # # #   #     # #   # # # #     #         #   # # # # #       # # #     # # # # # # #   # # # # #
# # # ### ##### ####### # # # # ### ##### ####### ##### # ####### # # ### # ### ##### # # ### ######### ####### # ### ### # # ######### #
# # # #       #       # # # # #   #     #       #     # #       # # #   # #   #     # # #   #       # #       # #   #   # # #         # #
# ####### ##### ####### # # # # # ############# # # ### # # # # # # # # ### # ### # # ####### ### # # # ##### ######### ####### ##### ###
#   # # # #   #       # # # # # #             # # #   # # # # # # # # # # # #   # # # #   #     # #         #     #   #       #     # # #
# # # # # # ### # # ##### # # # # # # # ### # ### # # # # ### # # ### ### ### ####### # ####### ############### # # ########### ### ### #
# # #         # # #     # # # # # # # #   # # #   # # # #   # # #   #       #   #   #         # #             # #         # # #   #   # #
# # ### # # ### # ##### ### ##### ### ####### # # # # # # # # # # # # # # ### ### ##### # ####### ####### ### # # # ##### # # ### ##### #
# #   # # #   # #     #   #     #   #       # # # # # # # # # # # # # # #   #         # # # #           #   # # # #     #       # #   # #
# # # # # # # # # ### ### # # # # # # # ### ######### # # # ##### # # ### ##### ########### # ##### ### ### ##### # # # ### # # ### ### #
# # # # # # # # #   #   # # # # # # # #   #         # # # #     # # # #       #                   #   #   #     # # # #   # # #   #     #
# # # # # ####### ### ####### # ####### # # # ##### ##### ### ### # # ### # ### # ### ### ### # ### ### ##### ### # ##### # ####### #####
# # # # #     #     #       # #       # # # #   # # # # #   # #   # #   # # #   #   #   #   # #   #   #     #   # #     # #             #
# # # # # ####### # # ### # ############# # # ### ### # ### # # # # # ### ### # ### # # # # # # ### ##### # ####### ### ####### # # # ###
# # # # #     #   # #   # #             # # #       #     # # # # # #   #   # #   # # # # # # #   #     # #     # #   #   #   # # # #   #
# ### ### # ### # # # ### ##### # # # ### # # # # # # ### ### ### # # ### # ### # ####### # ####### ############# ##### ### ### # #######
# #   #   #   # # # #   #     # # # #   # # # # # #     #   # #   # #   # #   # # #     # #       #                   # #     # #       #
# ### # # ### # # ### ### # ##### # # # # ### ### # # ### # # # # # # # ### # # # # ### ####### ### ##### # ############# ##### # #######
# #   # #   # # #   #   # #     # # # # # #     # # #   # # # # # # # #   # # # #     #       #   #     # #                   # #       #
####### # ####### # # ### # # # ### # ####### ####### # # ####### # # # # ### ### # # # # ##### # # # # # ##### # # ##### # ######### # #
#       #     #   # #   # # # #   # #       #       # # #       # # # # #   # #   # # # #     # # # # # #     # # #     # #         # # #
### # # # ### ### # # ####### # # ##### # ### # ### # ########### # # # # ### # # # ##### ######### # # ### # # # # ####### # # # ### ###
#   # # #   # #   # #       # # #     # # #   #   # #           # # # # #   # # # #     #       #   # #   # # # # #       # # # #   #   #
####### # # ### # # # # ### ##### ##### ### # # # ######### # ### # # # # ##### # # ### ### # ##### ### # # # ### # ### ### # # ### #####
#     # # #   # # # # #   #     #     #   # # # #         # #   # # # # #   #   # #   #   # #     #   # # # #   # #   #   # # #   #     #
##### ### # # ### # # # # # ##### # ####### ### # ### # # ##### # ### # # # # # # # # # # ####### # ### ####### ### # # # # # # ### ### #
#         # #   # # # # # #     # #       #   # #   # # # #   # #   # # # # # # # # # # #       # #   #     # #   # # # # # # #   #   # #
### # # # # # ##### # # # # ####### ### # ### # ### # ##### ######### # # # # # ### ### # # # ### # ##### # # ### # # ######### ### # ###
#   # # # # #     # # # # #       #   # #   # #   # #               # # # # # #   #   # # # #   # #     # #     # # #   #   #     # #   #
# # # # # # # # # # # # # # ### ### ##### # # # # ##### ######### ### # # # ### # ####### # # # ### ####### # # ##### # # ##### ### # # #
# # # # # # # # # # # # # #   #   #     # # # # #     #         #   # # # # #   #     #   # # #   #       # # #     # #     #     # # # #
# # # # # # # ### # # # ### ####### # ### ### # # ### # # ### # ##### ### # # # # ### ##### # # # # # # # ### # # ### ##### # # # # ### #
# # # # # # #   # # # # #         # #   #   # # #   # # #   # #   #     # # # # #   #     # # # # # # # #   # # #   #     # # # # #   # #
# ### # ### # # # # # # ### # # ### ##### ### # # # # # # # ##### # # ### # ### # # # # # ### # # # # # ######### # # ### # # # # # ### #
# #   #   # # # # # # # #   # #   #     #   # # # # # # # #     # # #   # #   # # # # # # #   # # # # #         # # #   # # # # # #   # #
# ### # ### # # ##### # ### # # # # ### # ### ### # ### ### # # # ### ### # # ### # # # # # # # # ##### ####### ##### ##### ### ### # # #
#   # # #   # #   #   #   # # # # #   # #   # #   #   #   # # # # #     # # # #   # # # # # # # # #   #       #     #   # #   #   # # # #
# # # ##### # # # ### ##### ### ### ##### ### # # # # # # # # # ##### ### # # ### # # ####### # ### ### ### ####### ##### ######### # # #
# # # #   # # # # #       #   #   #     #   # # # # # # # # # #     #   # # # #   # #     # # #       #   # #     #               # # # #
### ##### # # ### ### # ##### # ### # # ##### ### ### # # # ######### # ##### ### # # # ### # # # ### # # ### ### ####### ######### # # #
#   # #     # #     # #     # #   # # #     # #   #   # # #         # #     # #   # # #   # # # #   # # #       #       #         # # # #
# # # # # # # ### # # # ########### # # ### ### # # # # # # ######### ####### ### # # ##### # # ### ### # # # ### # # ##### ### ##### # #
# # #   # # # #   # # #         # # # #   #   # # # # # # #     # # #       #   # # #       # #   #   # # # #   # # #     #   #     # # #
# ### # # # ### # # # # ### # ### # ### ####### # # # # # # ##### # ### ####### # # # ######### ### # ### ####### # # # # ##### ### # ###
# #   # # # #   # # # #   # #     #   #       # # # # # # #           #       # # # #         #   # #   #       # # # # #   # #   # #   #
# ### # # # # ##### # # # # # ### ####### ### ### # # # ### ### ### ##### # ### ### # # # # ### ### # ######### ####### ##### ####### # #
# #   # # # # #     # # # # #   #       #   #   # # # # #     #   #     # #   #   # # # # #   #   # #         #       #             # # #
# # # ### ##### # # # # ####### # ##### # # ##### ### ### # # # ######### # ######### # # # ### ### ######### # # # # # # ############# #
# # #   # #     # # # #       # #     # # #     # #     # # # #         # #         # # # # #     #         # # # # # # #             # #
# # # # # # ### # # # # # # ### # # # # # # # # # # # # ### # # ######### ##### # ### ##### ### ### # ### ##### # # # # # # # # ### #####
# # # # # # #   # # # # # #   # # # # # # # # # # # # # #   # #         #     # #   #     #   #   # #   #     # # # # # # # # #   #   # #
# ### # # ##### # # # # ### ### ### ##### # # ### ### # # # ### ############# ### ### ##### ### ##### ### ####### ### # ### ### ### ### #
# #   # # #     # # # #   #   #   #     # # #   #   # # # # #               #   # #     #   #       #   #       #   # #   #   # # #     #
# ### ### ### # # # ### # # # # ### ##### # # ### ### ##### ### ######### ### # ##### ######### # # # ### ### ####### # ######### ##### #
#   #   # #   # # #   # # # # #   #     # # #   #   #   #     #         #   # #     #     #     # # # # #   #       # #         #     # #
# # # ### # ### # # ### ##### # # # # # ######### ### # ### ### ### # ### ### ### # # # # # ### # ### # # ### ######### # ####### ### # #
# # #   # # #   # # #       # # # # # #         #   # # #   #     # #   #   #   # # # # # # #   #   #   #   #         # # # #       # # #
# # # # ### # # ### ### ### ### # # # ############# ##### ##### ### # ##### # ####### ### ### # # # ##### ### ### # ####### # ### #######
# # # #   # # #   # #     #   # # # #             #   #   #       # #     # #       #   # #   # # #     #   #   # #             #       #
### # # # ### # # # # # # # # # # # # # ##### # ##### # # # # # ####### # ### ##### # ##### # # # # ### # ### # # ### ### ### ###########
#   # # # # # # # # # # # # # # # # # #     # #     # # # # # #       # #   #     # #   #   # # # #   # #   # # #   #   #   #         # #
# # # ### # ### ##### # ####### # # # # # ### # ### ### # # # # ##### # # # ### # # # ##### # # ### # # # ### ##### # ### # ### ####### #
# # #   #   #   #     #     #   # # # # #   # #   #   # # # # #     # # # #   # # # #     # # # #   # # #   #     # #   # #   #         #
# # # ### ##### # # # # ### # # # # ### # ##### # # ### # ##### # # # # # # # # # # # # ##### # # # # ### ##################### ### #####
# # # #   #     # # # #   # # # # #   # #   #   # #   # #   #   # # # # # # # # # # # #   # # # # # # #                       #   #     #
# # # # # # # # # # ### ####### # # ### # ##### # # # # # # ### ### # ### # ##### ### ### # # ### # # # # # ### ### ####### ### # # ### #
# # # # # # # # # # #         # # #   # #     # # # # # # # #     # #   # #     #   #   # #     # # # # # #   #   #       #   # # #   # #
### # ####### # ### # # ##### # # # # ### # ### ##### # ### # # # ### ### # # ### # # # ##### ##### # ### # ##### # # ##### # # # #######
#   #       # # #   # #     # # # # #   # #   #     # #   # # # #   #   # # # #   # # # #         # # #   #     # # #     # # # #       #
### # # # # # ####### # # # # # ### # ### ### # # ##### ### # # # # ### # # ##### # # # # # # # # ##### # # ### # # # ##### ### #########
#   # # # # # #   #   # # # # #   # #   #   # # #   #     # # # # # # # # #     # # # # # # # # #     # # #   # # # #     #   #         #
# # # # ######### # ### # ##### ### # # # # # # ### # # # ### ### # # ########### ### ### # # # # ### # # # # # # # # # # # ### ### # # #
# # # #   #         #   #     #   # # # # # # #   # # # # # # #   #             #   #   # # # # #   # # # # # # # # # # # #   #   # # # #
### ##### # ### # # ### # ### # # # # # # # # # # # # # ### ### # # # # ### ##### ######### # ### # ####### # ### # # # # ##### # # # ###
#       # # #   # # #   #   # # # # # # # # # # # # # #   #     # # # #   #     #         # # #   #       # #   # # # # #     # # # # # #
# # ### ### # # # # # # # # # # # ##### # # # ### # # # ### ### # # # # # ####### ### # ### # # # # ####### # ####### ### # # ### # ### #
# #   #   # # # # # # # # # # # #   # # # # #   # # # # # # #   # # # # #       #   # # #   # # # #       # #       #   # # #   # #     #
### # ##### ### # # # # # # # ### ### ### # ##### # # # # ##### ### # # ####### ### ### ### # # # # # ##### # # # # # # # ### # ### #####
#   #     # #   # # # # # # #   #     # # #     # # # #     #   #   # #       #   #   #   # # # # # #     # # # # # # # #   # #   #     #
# # ######### # ### # # # # # ### # ### # ### # ### # # # # # # ### ########### # # # ##### ### # # ### ##### # # ##### # # # # ##### # #
# #       # # #   # # # # # # # # #     #   # # # # # # # # # # #           # # # # #     # #   # #   # #   # # #     # # # # #     # # #
# # ####### ### # # # # ### # # # ####### ### # # # ##### ### # ### # # # # # # ##### ##### ### ### ##### ### # # ##### ### # ###########
# #       #     # # # #   # # #         #   # #   #     #   # # #   # # # #   #     #     # #   #           # # #     #   # #          x#
#########################################################################################################################################
