#########################################################################################################################################
#o                                        #                           # #     #               # #   #   #                   # #   # #   #
# ####### ####### # # ##### # ##### ####### ########### # ############# # ##### ### # ### ### # # ##### # ####### ########### # ### ### #
#       #       # # #     # #     #                   # #           #             # #   #   #       # #   #     #       #   # # #   #   #
# # ####### ### # ### # # # ##### # # # ### # # ### # # ### # ##### # ######### ##### # # ### ####### # ### ############# ### # # ### ###
# #       #   # #   # # # #     # # # #   # # #   # # #   # #     #           #     # # #   #   # # #                 # # # # #         #
# # # ####### ### # # # # # ### ##### ####### ##### ##### ##### # # # ############### # # ####### # # ################# # # # # #########
# # #       #   # # # # # #   #     #     #       #     #     # # # #               # # #               # #           #   # # #         #
# # # # # # # # # ### ### # # # ####### ### # # ### # ### ########### # # ### # # # # ### ##### # # ##### # ####### ### ### # # ##### ###
# # # # # # # # #   #   # # # #       #   # # #   # #   #           # # #   # # # # #   #     # # #     # # #   # #   #   #         #   #
# # ### ############### # ##### ### # ####### ### # ######### # ##### # # ### # ### # # ######### ####### # # ### ##### ### ########### #
# #   #               # #     #   # #       #   # #         # #     # # #   # #   # # #     #   # # # #   # #       # #               # #
# # # # # # # # # # ##### ##### ################# # ### # ### # ##### ### ### ####### # ##### ##### # # ### # ####### # ##### # # ### ###
# # # # # # # # # #     #     #   #       # #   # # # # #   # #     #   #   #     #   # # #                   #             # # #   #   #
# # # # # # ### # # ####### ####### ####### # ####### ### ##################### ######### # ################### ############# ### # #####
# # # # # #   # # #       #           # #   #           #     #         #     #   # # #   # #   # #     # #                 #   # #   # #
### # # ### # # # # # ### ############# # ### ########### ##### ##### # # ######### # ### # # ### # ##### # ######### ##### # # # ##### #
# # # #   # # # # # #   #   #                           #   #       # #           # # # #                           #     # # # #       #
# # # # # ### # # # # ### ### ####### ### # ##### # ##### ### ##### ######### ##### # # # ### ### # # ######### ##### ### # # ###########
#   # # #   # # # # #   #           #   # #     # #     #         #         #               #   # # #         #     #   # # #           #
# # # # # ### # ##### ##### ### ### # # # ######### ####### ##### ### ### ########### # # # # # # # # # ### ##### ### # # ### # #########
# # # # #   # #   #       #   #   # # # #         #       #     #   #   #           # # # # # # # # # #   #     #   # # #   # #         #
# # ### # ####### # # # # ### ####### ### # # # ### ### ### # # ##################### ### # # # ### ### # # # ##### ##### # # # # ##### #
# # #   #   #   # # # # #   #       #   # # # #   #   #   # # #     #               # #   # # # # #   # # # #     #     # # # # #     # #
# ### # ##### ### # # ### # ####### # ### # # ### # # # # # ######### ############# ### # # ##### # # ### # # # # # # # ####### # # #####
# #   #         # # #   # #       # #   # # #   # # # # # #   # #       # #       #   # # #       # # # # # # # # # # #     #   # #     #
# # ### ### # # ### # # # ############### ##### # # # # # # # # # ####### # ##### ##### # ### # # # ### # # ### # ### # ####### # #######
# # #     # # #   # # # #               #     # # # # # # # #                   #     # #   # # # #     # #   # #   # #       # #       #
# ### # # # ### # # # # # # # # ### ############### ####### # ### ### ########### ##### ### ##### # # # # # ### # ####### ######### #####
# #   # # #   # # # # # # # # # # #       # # # # #       # #   #   #         # #     #   #     # # # # # #   # #       #         #     #
# # # ### # # # ### # ### # ### # ######### # # # ##### ### # # # # # ### # # # ### ##### # # ######### # ### # # # ####### ### # # # ###
# # #   # # # # #   #   # #   #                       #   # # # # # #   # # #     #     # # #         # #   # # # #       #   # # # #   #
# # # # # # # # ### # # # # ### # # ######### # # # # # ### # # # # ##### # ### # ################# ##### ### ### ########### ### # # ###
# # # # # # # #   # # # # # #   # #         # # # # # #   # # # # #     # #   # #     #           #     # # # #             #   # # #   #
# # ### # # ### ### # # ### ### # ##### ######### ##### # # # ### ### ##### # ######### ########### ##### # ##### ##### # # # ### ### # #
# # #   # # # # #   # #   #   # #     #         #     # # # #   #   #   #   #                     #     #       #     # # # #   #   # # #
# # # # ### # # # # ##### ####### # # # ######### # ### # # # # # ### ##### # ### ### # ####### ##### ##### # # # # ##### # ### # ### ###
# # # #   #   # # #     #     #   # # #         # #   # # # # # #   #     # #   #   # #       #     #     # # # # # #   # #   # #   #   #
# # # # ### ####### # # # # # # # # # ####### # ##### # ### # # # # # # ######### ##### # # # # ##### # # # ##### ### ####### ### # # # #
# # # #   #     #   # # # # # # # # #       # #     # #   # # # # # # #         #     # # # # #     # # # #     #           #   # # # # #
# # # # # # # # # # ### # # # # # # # # # # # # ### ### # ### ### # ### # # # ### ### # ### # # # ### # # # # # # ##### # # ### # # # # #
# # # # # # # # # #   # # # # # # # # # # # # #   #   # #   #   # #   # # # #   #   # #   # # # #   # # # # # # #     # # #   # # # # # #
### # # # # # ### # # # # # # ##### ### ### ##################### ####### ### ### ##### ##### # # ### ### ### ### # # # ### # ##### # # #
#   # # # # #   # # # # # # #     #   #   #     #   #         #         #   #   #     #     # # #   #   #   #   # # # #   # #     # # # #
# # ##### # # # ##### ### ### ### # ### ### # ### ### ### # ##### # ### ### # ### # # # # # # # # ### ### ### ### # ### ### # ### # # ###
# #   #   # # #     #   #   #   # # #     # #           # #     # #   #   # #   # # # # # # # # # #     #   #   # #   #   # #   # # #   #
# # # ### # # # # # # ##### # # # # # # ### # # # # # # ### ### # # ### ##### # ####### # # ##### ##### ##### ### # # ############# #####
# # # #   # # # # # #     # # # # # # # #   # # # # # #   #   # # #   #     # #       # # #     #     #     #   # # #             # # # #
# # ### # # ### # ### # # ### ##### # # ### ### # # # # ####### # # # # ####### # # # # ### ### # # ##### ### ### ######### ### ##### # #
# # #   # #   # # #   # #   #     # # #   #   # # # # #       # # # # #       # # # # #   #   # # #     #   #   #         #   #         #
# ##### # # ### ### # # # ### ##### # # # # ####### # # ### # ####### # ### ####### # ##### ### # ### # # ######### # ### # # # ##### # #
#   #   # #   #   # # # # #       # # # # #       # # #   # #       # #   #       # #     #   # #   # # #         # #   # # # #     # # #
# ### ### # ### # ### # # # # ### # # # ### ########### # ######### ### ####### ### ############# # # ### ######### # ##### ####### # ###
#   # #   #   # #   # # # # #   # # # # #             # #         #   #       #   #         # #   # #   # #       # #     #       # #   #
# # ### # # ### # # # ### ### ### ### ### # # ######### ### ##### ##### # ######### # ##### # ### # ##### # ####### # ############# #####
# # #   # #   # # # #   #   # #     # #   # #         #   #     #     # #     #   # #     #     # #     #         # #           # #   # #
# ### # # # ### # ### # # ### # # # # ### # # ##### ### ### ### ### ### ##### # ##### ######### # ####### ####### ######### ##### ##### #
#   # # # #   # #   # # #   # # # # #   # # #     #   #   #   #   #   #     #       #         # #   #   #       #         #           # #
# ### # # # ######### ### ### ### # # ### # # # ### ### # # ##### ### # # ####### ### # # ########### ##### ### ### ####### ######### # #
#   # # # #         #   #   #   # # # #   # # #   #   # # #     #   # # #       # # # # #                 #   #   #       #       # #   #
# ######### # # # # # ### # # # ### ### # ##### # # ### ####### ### # # # ####### # ##### ### # ### ### ####### ### # ##### ### ### #####
# #         # # # # #   # # # #   #   # #   #   # #   #       #   # # # #       #       #   # #   #   #     # #   # #     # # #         #
# ### # ### # ##### ### # ######### ##### # # # # # ### # # ######### # # # ### # ####### ### # ### # ####### ####### # ##### ##### # # #
# #   # #   #     #   # #         # #     # # # # #   # # #         # # # #   # #       #   # #   # #               # #           # # # #
# # # ##### # # # # # # ######### ### ### # # # # # ### # # ### ##### ### ##### # ##### ### ### # ### ### # ### ### # ####### # # # ### #
# # # #     # # # # # #         #   # #   # # # # #   # # #   #     #   #     # #     #   #   # #   #   # #   #   # #       # # # #   # #
######### # # # ### ### ##### ####### ### # ### # # ##### # # ######### # # # ####### # # # # # ##### ##### ### ############### ##### # #
#     #   # # #   #   #     #       #   # #   # # #     # # #         # # # #       # # # # # #     #     #   #               #     # # #
##### # # ### # # ##### # ##### ### # # # # ##### # ####### # ### # ### # ### # ### # # # # # # # # # # ### ### # ### # # ######### ### #
#       #   # # #     # #     # # # # # # #     # #     #   #   # #   # #   # #   # # # # # # # # # # #   #   # #   # # #         #   # #
# # # # ##### # # ### # # # # ### ### # # # # # # # # # ##### ### # ### # ### # ##### # # ### # # ### # ### ##### # # # # ### ### #######
# # # #   #   # #   # # # # #       # # # # # # # # # #     #   # #   # #   # #     # # # #   # #   # # # #     # # # # #   #   #       #
### # # # ### # # ##### # # ### ### # ### # # # # # # # ### # ####### # # # ### # # ##### # # # # # # ### # ##### ### # # # # ### ##### #
#   # # # #   # #     # # #   #   # #   # # # # # # # #   # #       # # # #   # # #     # # # # # # #     #     #   # # # # #   #     # #
# ### # # ### # # ##### # ##### # ### ### # # # # # ### ### ### # # # ##### ### # ### # # # # # ### # # ### ### ### # ### # # ### # #####
# #   # # #   # #     # #     # #   #   # # # # # #   #   #   # # # #   #     # #   # # # # # #   # # # #     #   # #   # # #   # #     #
# # # # # ### # # ####### # ### # # ####### # # # # ### # ### # # ### # ### ##### # ### # # ### ### ### # # # # ### # # # ### # # ### ###
# # # # # #   # #       # #   # # #       # # # # #   # #   # # #   # # #       # #   # # #   #   #   # # # # #   # # # # #   # #   #   #
##### # # # ### # # # # # # # # # # ### # ##### # # # # # # ### # # ### # # # ### # ##### # # # ### ### # ### # ##### ##### # # ### # # #
#     # # # #   # # # # # # # # # #   # #   #   # # # # # #   # # #   # # # #   # #   # # # # #   # # # #   # # #   #     # # #   # # # #
# ### # # # # # # ### # # # # # # # ### # ##### ### # # # # # # ### ### # # # ### ### # ### ##### ### ##### ### # ####### ### # # # # ###
# #   # # # # # #   # # # # # # # #   # #   #     # # # # # # #   #   # # # #   #   #     #     #         #   #         # #   # # # #   #
# # # # # # # # # # # ### # ### ### ### ####### ### # ### # ####### ### # # ### # ### # # # # ##### # # # # ### # # ######### # # ### # #
# # # # # # # # # # # #   #   #   #   #     #     # #   # #       #   # # #   # #   # # # # #     # # # # #   # # #         # # #   # # #
# # # # ####### # ######### ### # # ### # ### # # # # # # # ### ### ##### # # ### # # # ### # # ### # # ### # # # # # # ##### # # ### ###
# # # #     #   #         #   # # #   # #   # # # # # # # #   # # #     # # #   # # # #   # # #   # # #   # # # # # # #   #   # #   #   #
# # # # ### ##### # ##### # ### ### ### ######### # # ##### # ### # ##### # ######### # ##### ### ### # # # ### ### # # # ### ### ##### #
# # # #   #   #   #     # #   #   # # #     # #   # #     # #     #     # #         # #     #   #   # # # # #     # # # # #     # #   # #
# # # # # # # ### # # # # ### # # # # # ##### ### ### # ### ##### ### # # # # ##### # # # ##### ##### ####### # # # # # ##### ### # #####
# # # # # # # #   # # # #   # # # #   #         #   # #   #     #   # # # # #     # # # #     #     #   # # # # # # # #   #   #         #
# ### # # # ### # # # # # # # ##### ### # # ### # # # # # # ### ### ### ##### ### # # ### # # ########### # # ### ### # ##### # # # # ###
#   # # # # #   # # # # # # #     #   # # #   # # # # # # #   #   #   #     #   # # #   # # #         # #   #   #   # #   #   # # # #   #
# ##### ### # # # ### # # ### # # # # # ######### # # # # # ### # # ### # ### ### # # # # # # ### ##### # ### # # ### # # ### ### # # # #
#     # #   # # #   # # #   # # # # # #       #   # # # # #   # # #   # #   #   # # # # # # #   # #         # # #   # # #   #   # # # # #
# ##### # # ### ####### # ##### ### # # ######### ### ##### ### ##### # # # # # ##### # ##### ### # ########### # ### # # ### ### # # # #
#     # # #   #       # #     #   # # #         #   #     #   #     # # # # # # #   # #     #   #             # #   # # # #     # # # # #
# ##### ### ### # ####### ### ### # # # # # # ### ### ### # ### ### ### # ####### ##### # # ####### # ### # ####### # # # # # # ### ### #
#     # #   # # #     #     #   # # # # # # #   # #     # #   #   #   # #             # # #       # #   # #       # # # # # # #   #   # #
# ### ####### # ### ### # ### # ### ######### ### ### ### # # # ### # ### ### # ####### # # ############# # # # ####### ### # # # # ### #
#   # #           #   # #   # #   #       #   #     #   # # # #   # #   #   # #       # # #             # # # #       # #   # # # #   # #
# ####### # # # # ### # # # # # # # # # # # # # # # # # # # ### # # # # # ### # # # ### # ### # # # ##### ####### # ### # # # ##### ### #
#       # # # # #   # # # # # # # # # # # # # # # # # # # #   # # # # # #   # # # #   # #   # # # #     #       # #   # # # #     # #   #
# ### # # # # # # # ### # ### # ### ##### ### # # ### ### # # # ### ##### # ### ######### ##### ######### ### ### ##### ### # # ### # # #
#   # # # # # # # #   # #   # # #       #   # # #   #   # # # #   #   #   #   #     #   #   #           #   #   #     #   # # #   # # # #
# ### ####### # # ####### ##### ### # ### ### # # # # # ####### ####### # ##### # # # ##### ### # # ### # # # # ####### ### # # ### ### #
#   # #       # #       #     # #   #   #   # # # # # #       #       # #     # # #       # #   # #   # # # # #       #   # # #   # #   #
# ### ##### # # # ### ### ### # # # # ### # # # ##### # # ########### # # # ##### # ### # # # # # # # ##### ##### # # ### # # # ### ### #
#   # #     # # #   #   #   # # # # #   # # # #     # # #           # # # #     # #   # # # # # # # #     #     # # #   # # # #   #   # #
# # # # # # ##### ####### ### ##### ########### ### ##### ##### ##### ### ### # # ##### # # # # ### ### # ##### ########### # # # ##### #
# # # # # # #           #   #   #         #       #     #     #     # #     # # #     # # # # #   #   # #     #           # # # #   #   #
# ### # # ##### # ### ####### ##### # # ##### # ### ### # # # # # ### ### ### ####### # # # # # # # ##### ####### ### ######### ### ### #
# #   # #   #   #   #       #   #   # #   # # #   #   # # # # # #   #   #   #       # # # # # # # #     #       #   #   #     #   # #   #
# # # # # # ### # # # # ######### # # # ### # # # # ##### # # # # # # ### # # # ########### # # # # ##### ######### # ### ############# #
# # # # # # #   # # # #         # # # #   #   # # #     # # # # # # # #   # # #           # # # # #     #         # #               #   #
# # ### ### # # # ### # # # ##### # # ####### # # # ### ### ### # ### # # ### # ### # ##### ### ### # # # ### # # # # ### # ##### # # # #
# # # #   # # # #   # # # #     # # #   #     # # #   # #     # #   # # #   # #   # #     #   # #   # # #   # # # # #   # #     # # # # #
# # # # ####### # ##### ### # # ### # # ### # # # # # ##### # # # # # ### ### # ### ######### # # # # # # # # # # # # # # # # # # # # # #
# # #     #     #     #   # # #   # # # #   # # # # #     # # # # # # #     # #   #         # # # # # # # # # # # # # # # # # # # # # # #
# # ### # ### # # ##### ### # ### # ### ### # # ##### ### # # ##### ### # # # ### ##### ### ####### ##### ######### # ######### # ### # #
# # #   # #   # #     #   # #   # # # #   # # #     #   # # #     # #   # # #   #     #   #     #       #         # #         # #   # # #
# # # # ### # # # # ### ##### # # ### # # ##### ##################### ### ##### # # ##### # ### # # ### # # ### # # ### # # # # ####### #
# # # #   # # # # #   #     # # #   #   #   #                       # #       # # #     # #   # # #   # # #   # # #   # # # # #       # #
# ### # # ### # # # ########### # ##### # # ### # # # ### ### ######### # # # # # ############### # # # # # # ### # # # # # # ### ##### #
# #   # #   # # # #           # # #     # # #   # # #   # # #     #   # # # # # #               # # # # # # #   # # # # # # #   #     # #
####### # # ### # # # # ####### ##### # # ##### # # # # ### ####### ### # # # # # # # ##### # # # # # # ##### # # # ### ### ### #########
#       # #   # # # # #       #     # # # #     # # # #       #       # # # # # # # #     # # # # # # #   # # # # #   #   #   #       # #
# ##### # # # ### # # # # # ####### # # ####### ### # # # # # # ####### ### # # # ### # ######### # # # ### # ### # # ### # ########### #
# #     # # # #   # # # # #       # # #   #       # # # # # #         #   # # # #   # #         # # # #     #   # # #   # #   #         #
# # # # # # # # ### ### # ######### # # ### # # # ### # ### # ### ### ### # # # # # # ##### ### # # ### # ####### ### # ####### ####### #
# # # # # # # # #     # #         # # #   # # # #   # #   # #   #   #   # # # # # # #     #   # # #   # #       #   # #               # #
### ##### ### # # # ### # ### ######### # # ### # # # # ##### ### ########### # # # # ################# ### ### # ### ### ### # # # # # #
#   #       # # # #   # #   #         # # # #   # # # #     #   #           # # # # #               #     #   # #   #   #   # # # # # # #
# # ### # ##### ### # ### # ########### # ### # # # # # # # # ### # ### # ##### # # # # # ########### ### ####### # # # ### # # ### #####
# # #   #     # #   # #   #           # # #   # # # # # # # # # # #   # #     # # # # # #         # # # #       # # # #   # # #   # # # #
# ##### # ### # # # # ### # ########### ####### # ##### # # # # # ### # ####### # ### # # ##### # # ### ####### ### # ##### ####### # # #
#   #   #   # # # # #   # #           #   #     #     # # # #   #   # #       # #   # # #     # #             # #   #     #       #    x#
#########################################################################################################################################
