#########################################################################################################################################
#o                          #         #       # #                 #   #         #                 #       # # # #               #     # #
# ##### ##### ####### # ##### ##### ### ####### # ####### ######### ### ##### ### ### ### # ####### ### ### # # # ############# ### ### #
#     #     # #     # #           #                     #                   #       #   # # #   #     #                       # #     # #
# # ########### ##### ######### ######### ############# ######### ##### # ### ##### ######### ### ##### # ### ##### # # ######### ##### #
# #     #   #       #         #     # # # # # #       #         #     # #   #     #   #               # #   #     # # #     #   # # #   #
# # ##### ### ##### ######### # ##### # ### # # ##### ##### # # # # ######### # ####### ##### # ##### # ### ### ### # # ##### ### # # ###
# #               #         # #     # #             #     # # # # # #     #   #             # #     # #   #   # # # # # # #           # #
# ##### ####### ######### ######### # # ####### # # # ### ####### ### ##### # # ### # # # ##### ### ######### # # ##### # # ########### #
#     #       #         #     # # #           # # # #   #       #         # # #   # # # #     #   #         # #       #         # #   # #
# # ######### # ####### # ##### # ### # # # ##### # # # # ######### # # ##### ### # # ### ### # ### # # ### # ############### ### # ### #
# #         # #     # # #           # # # #     # # # # #         # # #     #   # # #   #   # #   # # #   # #         #     #           #
# ### # # # ######### ############### # ### ### # # ##### # ####### # # ##### # ### # # # ### # ### # ####### # ##### # ### # # ##### # #
#   # # # #   # # #                 # #   #   # # #     # #       # # #     # #   # # # #   # #   # #       # #     #     # # #     # # #
# ### ### ##### # # ### ##### # # ##### ### # ### # ### ######### # # # # # # # ### # # # ### ##### ### # # ########################### #
#   # #               #     # # #   # #   # # #   #   #         # # # # # # # #   # # # #   #   # #   # # #                         # # #
# ####### ### # ### # ##### # # ##### # ### # ### ### ### ### ### ### # # # # ##### # ### ####### ### ##### # ### # # ### # ##### ### ###
#     #     # #   # #     # # #       #   # #   #   #   #   #   #   # # # # #     # #   #   # #     #     # #   # # #   # #     #       #
# # # ### ### # # ##### ### ### ####### # ####### ####### # # ##### ##### ### ####### # ##### # ### ####### # # ### ############### ### #
# # # #     # # #     #   #   #       # #     # #       # # #     #     #   #       # #           #       # # #   #               #   # #
# ####### # # # # # # ##### # # ######### ##### ##### ####### ####### ####### # # # # ### # ### # # ##### # ######### ### ### # ##### ###
#   #     # # # # # #     # # #         # #         # #     #       #       # # # # #   # #   # # #     # #         #   #   # #     #   #
# # ##### ### ### ##### # # ### ########### ### ### # # ##### # # ### ### ### ### ####### # ### ### ##### # ####### # ##### # ###########
# #   #     # # #     # # # # #         #     #   # #       # # #   #   #   #   #       # #   #   #     # #       # #     # #       # # #
# # ### # # ### ### ######### # # ####### ############### # # # # ### ####### ####### # ### ############### # # # # # # ##### ####### # #
# #   # # #       #           # #                       # # # # #   #     # #       # #   #               # # # # # # #   # #           #
# # # # # # # # ### # ############### ### # ##### ##### # # # ############# ############# # # # ### ### # # # # # # ### ### ##### ### # #
# # # # # # # #   # #               #   # #     #     # # # #                           # # # #   #   # # # # # # # #           #   # # #
# ### ### # # ##### ### ####### # ### ### # # # ##### ### # # ######### ####### ### # # # ### ### ####### # ##### ##### # # # ##### # # #
#   # #   # #     #   #       # #   #   # # # #     #   # # #   #     #       #   # # # #   #   #       # # #   #     # # # #     # # # #
# ######### # # # ### ##### # ##### # ### ### # ########### # ### ########### ##### # ####### # ### # ####### ######### # ### # # ##### #
#   #       # # #   #     # #     # # #   #   #           # #               #     # #       # #   # # # # #           # # #   # #     # #
# # # ### # ### # # ### # ### ####### ##### # ##### ############### ### ######### ### ##### # # ### # # # # ### ####### # ### ###########
# # # #   #   # # #   # #   #       #     # #     #               #   #         #   #     # # #   # #         #       # #   #           #
# # # # # # ### # ### # ### ######### # ### # # # ######### ##### # # # # ### ### ### ### ####### ### ### ### # # # # ### ### ### ### ###
# # # # # #   # #   # #   #       # # # #   # # #         #     # # # # #   #   #   #   #       # #     #   # # # # # #     #   #   # # #
# # ##### # # ### ##### # ##### ### ##### # # ##### ######### # ### ##### ########### # ##### # # ### ### # # # ##### ### ### ##### # # #
# # #     # # #       # #     #     #   # # #     #         # #   #     #           # #     # # #   #   # # # #     # # #   #     # #   #
# # ####### ##### # ### ######### ### ####### # # # # # # # # # ### ##### # ####### ### # ### # # ### # # ### # # # # # # ### # # ### ###
# # #           # #   #         #           # # # # # # # # # #   #     # #       #   # #   # # # #   # #   # # # # # # #   # # #   #   #
# # # # ### # # # # ### # # # # # # # # # ### # # # ### ##### # ### ### ### # ### # ### ####### # ### # # # ### # # # # # ### # #########
# # # # #   # # # #   # # # # # # # # # #   # # # #   #     # #   # # #   # #   # #   #     # # #   # # # #   # # # # #     # #         #
# # ### # # # # # # # # ##### # ### ####### # ### ########### ### # # ##### # # ####### ##### ####### ####### ######### # # ### ### # # #
# # #   # # # # # # # #     # # #         # #   #     # #   #   # #       # # #     # #   #         #       #       #   # # #     # # # #
### ### # # # ### # # # # # # ##### ### # # ##### # ### # ########### # # ##### # # # ##### ######### # ### ### # # ### # # # # # # ### #
#   #   # # # # # # # # # # #     #   # # #     # #                 # # # #   # # #                 # #   #   # # # #   # # # # # #   # #
### ####### ### # ####### ######### # # ### ##### # # ### # ### # # # # ### ### ####### ####### # ### ##### ### # ##### # # # # # ### # #
#   #           #       #         # # # #       # # #   # #   # # # # #       #   #   #       # #   #     #   # #     # # # # # #   # # #
# # ##### # # ### # # # # ### ####### ### # ####################### ### ##### ##### ##### # # ####### # ### # # # # ##### ### # ### ### #
# # #     # #   # # # # #   #       #   # #     #                 #   #     #           # # #       # #   # # # # #   #   #   #   #   # #
# # # # # # # # # # # ### # # ####### # ### # ### ######### ### ####### ### ######### # ### # # ####### ### # ### ########### # ### # # #
# # # # # # # # # # #   # # #       # #   # #             #   #   #   #   # # #     # # #   # #       #   # #   #       #     #   # # # #
# ##### ### # ### ### # # ### # # ### ##### # # ### ######### ##### ##### ### # ####### ### # ####### ##### # # ### # # # # # # # # # # #
#     # #   #   #   # # #   # # #   #     # # #   #       # #           #             #   # #   # # # # # # # #   # # # # # # # # # # # #
# # ####### # # ##### ### ### ### # ### # ### # # # ##### # ########### ### # # ### # ### ### ### # ### # ######### ##### # # # # ### # #
# # #       # #   # #   #   #   # #   # # #   # # #     #             #   # # #   # # # # # #   # #             # #     # # # # #   # # #
# ### # # # # # ### ### # ####### # # # # # # # ### # # # ### ####### # # # # # # ### # ### ##### # ############# ######### # # # ### # #
#   # # # # # #       # #       # # # # # # # #   # # # #   #       # # # # # # #   #                                     # # # #   # # #
# ##### # # ### # ### ### # ### # # # ##### ### # ### ######### ### ### # ### # ########### ##### # # ######### ########### # # # ### # #
#     # # #   # #   #   # #   # # # #   # # #   #   #         #   #   # #   # #           #     # # #       # #           # # # #   # # #
# # ##### # # # # # # ### ####### ### ### ### # # # # # # ##### ####### # ####### ### # # # ### # ##### # ### ########### # # # # ##### #
# #   #   # # # # # #   #       #   #       # # # # # # #     #       # #       #   # # # #   # #     # #               # # # # #     # #
# # # ### # # # ### # ### ####### ####### ##### # # # # ### ##### ####### # ####### # # # # # ##### # # ### # # ######### ####### # # # #
# # # #   # # #   # # #         #       #     # # # # #   #     #       # #       # # # # # #     # # #   # # #         # #     # # # # #
# # ### # ### # # # # ### ### ##### ##### ### # # ### ##### # # ### # # # ######### # # ##### # # ####################### # ### # ### # #
# #   # #   # # # # #   #   #     #     #   # # # #       # # #   # # # #         # # #   #   # #       #       #       #     # #   # # #
# # # ### # # # ### # ### # # # ### ####### ### # # # # ### ### # # ####### # # ##### # ##### ### # ##### ##### # ### ############### # #
# # #   # # # #   # #   # # # #   #       #   # # # # #   #   # # #       # # #     # #     #   # #           #     #               # # #
# ### ### # # # # # # # # ##### # # # # # ##### # # ### # ######### # # # # # # ##### # # ### # # # # ### ####### # # # # # #############
#   # #   # # # # # # # #     # # # # # #     # # # # # #         # # # # # # #     # # #   # # # # #   #       # # # # # #   # #     # #
# # # # # # ### ##### ### ##### ### # # # ##### ### # # ##### # # # # ### # # # ### # # ### ### ### # # # # ### # # # # # # ### # ##### #
# # # # # #   #     #   #     #   # # # #     #   #   #     # # # # #   # # # #   # # #   #   #   # # # # #   # # # # # # #             #
# # ### # # ### # ### # # ##### ### ### # # # ### # ### ####### # # # # # ### # ### # # # ### ### # ### # # # ### # ### ### ##### ##### #
# # #   # # #   #   # # #   #     #   # # # #   # #   #       # # # # # #   # #   # # # #   #   # #   # # # #   # #   # #       #     # #
# ### # # # ### # ### # # ### # # ##### # ### # # # # # # # # ### ### # ### # # ### ### # # ### # # ### # # ### # # # ### # # # # # #####
# #   # # # #   # #   # #   # # #     # #   # # # # # # # # # #     # #   # # #   #   # # #   # # #   # # #   # # # # # # # # # # # # # #
##### # ### # # # ### ### ### # # # # # # ####### # # # ### ### # # # # # # ########### # # ##### ##### ### # ##### # # ##### ### # # # #
#     #   # # # # # #   #   # # # # # # #       # # # #   #   # # # # # # #           # # #     #   #     # #     # #       #   # #     #
# # # # # ##### ### ##### ##### # ### # # # # ### ##### ### ### # # # # ### ### ##### # # # ##### ##### ### # # ### # ### # # # # #######
# # # # # #             #   # # #   # # # # #   #     #   #   # # # # #   #   #     # # # #     #     #   # # #   # #   # # # # #       #
### ### # # # # # # ##### ### # # # # # # # ##### # # ##### # # # # # # # # ##### # ### ### ### # # # # # # # # ######### # # ### # # # #
#   #   # # # # # #     #     # # # # # # #     # # #     # # # # # # # # #     # #   #   #   # # # # # # # # #         # # #   # # # # #
# # ### ### ### # # ### ### ####### ### # # ### ### ### # ### # ####### # ##### ######### ### # # ### # # ### ####### # ##### # ####### #
# # #     # #   # #   #   #       #   # # #   #   #   # #   # #       # #     #   # #   #   # # #   # # #   #       # #   #   #     #   #
### ### ##### # ### ### # ### # ######### # # # # # ### # # # # ### # ### # # ##### # ##### # ########### # # # # ##### # # # # # ### # #
#   #     #   #   #   # #   # #       #   # # # # #   # # # # #   # #   # # #             # #           # # # # #     # # # # # #   # # #
# # ### # ### # # # ### ##### ##### ### # # ####### # ### # # # # # ### # # # # ### # ####### # # # ### # ### # ### # # # # # # # # #####
# # #   # #   # # #   #     #     #   # # #       # #   # # # # # #   # # # # #   # #       # # # #   # #   # #   # # # # # # # # #     #
### ### # # # # # # # # # # # # # # # # # # # ####### ####### # # ####### # # ### # # # ####### # ####### ##### # # ### # # # # ### #####
#   #   # # # # # # # # # # # # # # # # # # #       #       # # #       # # #   # # # #       # #   # #       # # #   # # # # #   #     #
### ### # ### # # # ##### ##### ### # ### # # ############### ### ########### ### ### ############### ### # ####### ######### # # # # ###
#     # # #   # # #     #     #   # # #   # #               #   #           #   #   #                   # #       #       #   # # # # # #
### # # # ### # # # # ### # # ### ### ##### # # ########### ##### # # ####### # ### ####### ######### ##### ### # # # ### ### # ### ### #
#   # # # #   # # # #   # # #   #   # #     # #           #     # # #       # #   #       # #       #     #   # # # #   #   # # # #     #
# ##### ### # # # ### ####### # ### # # # # # # # ### # # # # # # # ##### ##### # ####### ### ########### # # ### ### # # # # # # #######
# #       # # # #   #       # #   # # # # # # # #   # # # # # # # #     #     # #       #               # # #   #   # # # # # #         #
# ### # # # # # # # # # # # ### ### # # # # # # # # ### ### # ########################### # # # ### # # # # ####### ######### # # # # ###
# #   # # # # # # # # # # #   #   # # # # # # # # #   #   # #           #         #     # # # #   # # # # #       #         # # # # # # #
# # # ### ### # # # ### ### ####### # ### # ### ### # # # # # ### # # # # ######### ### # # # # # ### ##### ################# # ### # # #
# # #   # #   # # # #     #       # # #   #   #   # # # # # #   # # # #               # # # # # #   #     #                 # #   # #   #
##### ### # # ### # # # # ### ### # ##### ##### ##### # # ### # # # # ####### ####### ####### # # # # ### ####### ### ######### ### # ###
#       # # #   # # # # #   #   # #   #       #     # # #   # # # # #       #       #       # # # # #   #       #   #       #     # #   #
##### # ### # # # # # # ### # # ### # # # ### # ### # # # ####### ### ####### ##### ### ### # ####### # # ######### ####### ### # # # # #
#     # #   # # # # # #   # # #   # # # #   # #   # # # #       #   #       #     #   #   # #       # # #       # #       #   # # # # # #
### # # # # # # # ### # # # ########### # ### # ### ### # ### # # # # ### # # # # # # ####### # ### # # # ### ### ### # ### # ### ### # #
#   # # # # # # # #   # # #           # #   # #   #   # #   # # # # #   # # # # # # #       # #   # # # #   #       # #   # #   #   # # #
# # # # # # ### # # # ######### ### ##### ### # # # ##### # # # # ### # ####### # ### # ### # ##### ### ### # # ### ### # # ##### # ### #
# # # # # #   # # # #         #   #   #     # # # #     # # # # #   # #       # #   # #   # #     # #     # # #   #   # # #     # #   # #
# # # # # # # # # ### ##### ### # # # # # # # ### # ### ##### # ##### ####### # ### # # ########### # # # # ### ### # # # # # ### # # # #
# # # # # # # # #   #     #   # # # # # # # #   # #   #     # #     #       # #   # # #           # # # # #   #   # # # # # #   # # # # #
### # # # # # # # # # ### # ### # # ### # # # # # # # ########### ### # ### # # ####### # ### # # ### # # # ### ##### # # # # # # # # ###
#   # # # # # # # # #   # #   # # #   # # # # # # # #           # #   #   # # #       # #   # # #   # # # #   #     # # # # # # # # #   #
# # ### # # # # # ### ### # ### # # ### ### # ##### # # ### ### ### # # # # # ######### ### ### ### ### # # ### # # # # # # # ##### # ###
# # #   # # # # #   # #   #   # # #   #   # #     # # #   #   #   # # # # # #         #   #   #   #   # # #   # # # # # # # #     # #   #
# ### # ### # # # # # # # # ##### # # # ##### # ##### # ### ### # ### ### ####### # ### # ### # ####### # # # # # ####### ### ### # # ###
# #   #   # # # # # # # # #     # # # #   #   #     # # # #   # #   #   #       # #   # #   # #       # # # # # #       #   #   # # #   #
# ### # # # # # ### ##### # # # # # # # ##### # ### # # # # ### ##### # ### ### # ### # # ##### # ######### # # # ########### ##### #####
# #   # # # # #   #     # # # # # # # #   #   #   # # #   # #       # #   #   # #   # # #     # #         # # # #       #   #   #       #
# # # # ####### # # # # # # ### ### # ##### # ### # ### # # ### # ### # # # ### ####### # # ##### ####### # # # # ##### # ####### # # ###
# # # #       # # # # # # #   #   # #     # #   # # #   # #   # #   # # # #   #       # # # # # #       # # # # #     #         # # #   #
# ### # ##### ##### ####### ####### # ##### # # # # # # ### # ### # ### # # # # # ### ### # # # ### ######### # # # ######### ##### # # #
# #   #     #   #     # # #       # #     # # # # # # #   # #   # #   # # # # # #   #   # #       #         # # # #         #     # # # #
# ##### ##### ### # # # # # # ####### # ##### ##### # # ### # ### # ##### # # # ##### ##### # # ############### # # # ##### ### # # # # #
# #         #   # # #     # #       # #   #     #   # #   # #   # #     # # # #     #   # # # #               # # # #     #   # # # # # #
##### # # # # ### ### # ### # ### ### # # ### # ### # # ### # ### # ##### # # # ### # ### # ### # # ############# ### # ######### ### ###
#     # # # #   #   # #   # #   #   # # #   # #   # # #   # #   # #     # # # #   # #     #   # # #   #         #   # #         #   #   #
# # # # # # # # # ### # # ############# ##### # ##### # ### ##### # # # # ##### ############### # # ### ##### # ####### ### # ### ### # #
# # # # # # # # # # # # #           #       # #     # #   #     # # # # #     #               # # #         # # # # # #   # #   # #   # #
# ### ### # # # ### # ##### ##### ### # # # ### # # ### ### ### # # # ### ##### # ############### # ##### ####### # # ### ### ##### # # #
# #     # # # #   #       #     #   # # # #   # # # #   #     # # # #   #     # #         #     # #     #     # # # #   #   #     # # # #
# # # # # ### # # # # # # # ### ##### # # # # # # # ### # # # ### ### ### ##### # # # ##### ########### # ##### # # # ##### ######### ###
# # # # # #   # # # # # # #   #   #   # # # # # # # #   # # # # #   #   #   # # # # #                 # #   # # #     #   #   #     #   #
### # ### ### # ### ### # ########### # # ####### # ### # # # # ##### # ##### ### # ####### # ############### # # ##### ####### ####### #
#   #   #   # #   #   # #         # # # #     # # # #   # # #       # #         # #       # #   #                                     # #
# # # # # ##### ### ### # # # # ### ### # # ### ### ### ### ############### # ##### # ### # ##### ####### # ######### ### # ### ### # ###
# # # # #     # #     # # # # #       # # #       # #     #               # #     # #   # #             # #         #   # #   #   # #  x#
#########################################################################################################################################
