#########################################################################################################################################
#o      #           #         #             #   # #                       #               # # #       # #             #           # # # #
# # ### # ########### ######### ############# ### # ####### # ####### ### # ############### # # ##### # # ### ######### ####### ### # # #
# #   #             #             # #     # # #     #     # #       #   #               # # #       #       #                 #         #
# ### # # # # ####### ######### ### # ##### # # ##### ############# # ########### # ##### # # ############# ##### # # ######### # ##### #
#   # # # # #                 #                 # #       #       # #           # #   #                   #     # # #         # #     # #
# # ######### # ############### ### ### ##### ### # ####### ######### ### ### ######### ######### ####### ##################### # ### ###
# #       # # #               #   #   #     #                       #   #   #           #       #       #                     # #   #   #
# ######### ##### # # # ### # ##### # # ### # ####### ### # # ####### # # # # ##### ##### ####### # # # ############### ####### # # # # #
#       #       # # # #   # #     # # #   # #       #   # # #       # # # # #     #           # # # # #               #       # # # # # #
# # ##### ################### # # # # ### # # # # ### # # # ######### ### # ######### ##### # # ######### ### ##### ### ### ### # ### # #
# #               #         # # # # #   # # # # #   # # # #         #   # #         #     # #     #     #   #     #   #   #   # #   # # #
# # ######### ### # ### # ##### # ##### ##### ### ##### ### # ####### # ### # ##### ### ### # ##### ####### # ############### # # ##### #
# #         #   #     # #     # #     #     #   #     #   # #       # #   # #     #   #   # #             # #               # # #     # #
# # # ######### ##### # # ### ##### ########### # # ### ### # ####### ### ########### ### ### ##### # ### ############# # # ### # # # # #
# # #         #     # # #   #     #           # # #   #   # #       #   #           #   # # #     # #   # # #         # # #   # # # # # #
# # # ######### ####### ################### # # # # # ### # # # ####### # # ####### ####### ##### ### # ### # ##### ### # ### # # # # # #
# # #         #       #                   # # # # # #   # # # #       # # #       #             #   # #           #   # #   # # # # # # #
# ### # # ####### # ### ########### ##### # ### ### ### ##### # ########### ################### # # # ####### # ####### ########### ### #
#   # # #       # #   #       #   #     # #   #   #   #     # #   # #     #           #       # # # #       # #       #           # #   #
# # # ### # # # # # ########### ### ######### ##### ##### # ####### # ############# ### ##### ######### # # ##### # ### ########### #####
# # #   # # # # # #               #         #     #     # #                       #         #         # # #     # #   #   #       #     #
# ### # # # ### ####### ######### ####### ##### # ### ##### # # ##### ####### ### ####### ################### # # ##### ### #############
# #   # # #   #       #         #       # #   # #   #     # # #     #       #   #       #       # #     #   # # #     #   #           # #
# # # # # ##### # ##### # ### ####### ### # ######### ##### ### # # ### # # # # # ##### # ####### # ### # ############### # ########### #
# # # # #     # #     # #   #       #   #           #     #   # # #   # # # # # #     # #             #                 #               #
# # # ### ######################### ### ### ### ### ############# # ### # ### # ### ######### # # # ##### # # ### ##### ####### # #######
# # #   #                   #     #   #   #   #   #             # #   # # #   #   #         # # # #     # # #   #     #       # #       #
# # # # # # # ##### ######### ### ####### ### ### ##### # ##### # # ######### # # # # # ##### ### ### # # ### ####### # # # # ####### ###
# # # # # # #     #             #       #   #   #     # #     # # #         # # # # # #     # #     # # #   #       # # # # #       #   #
# ### # # ### ### # # ##### ### ##### ### # # ##### # ##### ### ############# ####### # ####### # # # ### # ##### ####### # ### ### #####
# #   # #   #   # # #   # #   #     #   # # #     # #     #   #         #   #       # #       # # # #   # #     #       # #   #   #     #
# # # ### # # ########### ######### ### # # # ### # # # # # ####### ##### ### # ####### ######### # ####### # ### # # ### ##### #########
# # #   # # #                     #   # # # #   # # # # # # # #   #         # #       #         # #       # #   # # #   #     #         #
##### # # # # ######### # ############# ##### # # # ### # # # # ################### # ##### ### # # # ##### ##### ### ### # # # # ### # #
#     # # # #         # #             #     # # # # #   # #         #             # #     #   # # # #     #     #   #   # # # # #   # # #
##### ####### # ### # ### ######### ####### # ######### ####### # ### ##### ######### # # # ######### ### # # # # # ### # # ### # # ### #
#         #   #   # #   #         #       # #         #       # #         #         # # # #         #   # # # # # #   # # #   # # #   # #
##### ### ### # # # ##### # # ### ##################### ### # ### ### ########### ### # # # ##### ##### ##### # # ######### # # # ### # #
#       #   # # # #     # # #   #             # #     #   # # #     #           # # # # # #     # #   #     # # #       # # # # #   # # #
##### # ##### # ######################### ##### # ### # # # ##### # # # ########### ### ### ##### # ######### ### # ##### # ### # ### # #
#     #   #   #               #         # #         # # # #     # # # #               #   #     #           #   # #     # #   # #   # # #
# ### # ### # ### ####### # # # ##### ##### ######### # # ### ### # # # # # ### ### ##### ### ############# ### ### # ### ######### #####
# #   # #   #   #       # # #       # # #           # # #   #   # # # # # #   #   #     #   #             # # # # # #             #     #
### # ##### # ##### # # # ### ##### ### # ##### # # ##### # # # # ##### # ### ### # # # # ####### ########### ### ##### # ########### ###
#   #   #   #     # # # #   #     #           # # #     # # # # #     # #   #   # # # # #       #   #                 # #           #   #
# # # # # # # # # ### # # ### ### ### # # ####### ### # # # # # # # # # # ### # # ### # ### # ### ### ##################### #############
# # # # # # # # #   # # #   #   #   # # #       #   # # # # # # # # # # #   # # #   # #   # #   #         #               #       #   # #
# # # # # # # # ##### ### # # # # # ### # # # ##### # # ####### # # # # # ### # # ### # # ### ######### ### ##### # ### ########### ### #
# # # # # # # #     #   # # # # # #   # # # #     # # #     # # # # # # #   # # #   # # #   #         #         # #   #               # #
# # # # # ### # # # # ### # # # # # # # ### # ############### # # # # ### # # ######### ######### ##### # # # ### ####### ### ######### #
# # # # # #   # # # #   # # # # # # # # #   #                 # # # #   # # #       #     # #   #     # # # #   #       #   #           #
### # # # # # # # # ##### ######### ### ### ####### ### ### ######### # ############# # # # # ####### ############# ### ########### #####
#   # # # # # # # #     #         #   # #         #   #   #         # # #           # # #           # #           #   #           #     #
### # ### # # # # # # # ####### ######### # # ### ### # # ############# # ####### ##### ##### ##### ### ### # # ### # ### ### ####### ###
#   # #   # # # # # # #       #         # # #   #   # # #       # #   #         # # #       #     #       # # #   # #   #   #       #   #
### # ### # # ### # # # ##### # ################### ##### ####### # ##### # ##### # ### # # ### # # ### # # # ### # ### ### # # # # # ###
#   #   # # #   # # # #     # #       # # #       #     #               # #     #   #   # #   # # #   # # # #   # #   #   # # # # # # # #
### # # # # # ##### ### ############### # # ##### # # # ######### # ########### # # ### ### ### # ##### # ### # # ####### ### # ####### #
#   # # # # #   #     #                       # # # # #   #   # # #           # # # #     #   # #     # #   # # #       #   # #   # # # #
# # # # ### # # ### ### # ### ##### ########### ##### # # # ### ####### # ### ### # # # # # # # # # ######### # ### # # ####### ### # # #
# # # # #   # # #     # #   #     #                 # # #             # #   #   # # # # # # # # # #         # #   # # #       #         #
# ### ### # # # # # # # # # ### # # ############### # # # # ####### # # # # # ##### ### # # # # # # ##### # ####### # ##### # # # #######
# # #   # # # # # # # # # #   # # #               # # # # # #     # # # # # #   #     # # # # # # #     # #       # #     # # # #       #
# # # ### ### # # # # # # # ### ### # # # ####### ####### ### ########### ##### # # ### # # ### # # # # # # # # ### ### ### ##### ### ###
# #     # #   # # # # # # #   #   # # # #   #   #     # #               #     # # #   # # #   # # # # # # # # #   #   #   #     #   #   #
##### # ##### # ##### ### # # ### ### # # ### ######### ############### # # # ### # ### # # ### # # ### # ### # # # ####### # ### # # # #
#     #     # # #       # # #   #   # # #       #                     # # # #   # #   # # # #   # #   # #   # # # #       # # #   # # # #
##### ### # # # # ### ### # ### ####### # # # ### ######### # ### ### ####### # # # ##### # ### # # # ######### ##### ##### ##### ##### #
#       # # # # # #     # #   #       # # # #             # #   #   #       # # # #     # #   # # # #         #     #     #     #   # # #
# # # ### # # # # # # # # # ### ######### ### # ### # # ### # ######### ### ##### # # # # # ### # # # # ### ### ####### # # # # # ### ###
# # #   # # # # # # # # # #   #         #   # #   # # #   # #         #   #     # # # # # #   # # # # #   #   #       # # # # # #       #
### # # # # # # # # # # # # # # # ####### # # ##### # ### ######### ##### # # ### ### ##### # ##### # # # # # ### # # # # # ### # ##### #
#   # # # # # # # # # # # # # # #       # # #     # #   #         #     # # #   #   #   # # #     # # # # # #   # # # # # #   # #     # #
### # ### # # ### # # ### # # # # # # # # ### ####### ##### # # # # # ######### ######### ######### # # # # ### # # ### ### ### # # # # #
#   #   # # # #   # # #   # # # # # # # #   #       #     # # # # # #         #   # #             # # # # #   # # #   # #     # # # # # #
### # # # ##### # # # ### # # # ### # ### # # # ### ####### # ####### ### ### ##### # ### ##### ### ### # # # ### ######### ####### ### #
#   # # #     # # # #   # # # #   # # #   # # #   # # #   # # #     #   #   # #   #     #     #   #   # # # # # #         #       #   # #
# # # # # # # ### # # # ### # ### # # # # # # # ### # # ##### # ############# # ### ############### # # ### # # ##### # ######### ### # #
# # # # # # #   # # # # #   #   # # # # # # # #   #         #     #         # #                   # # #   # #       # #         #   # # #
# # # # # # # # # ### ### # # ### # ##### ### # # # # # ##### ##### ########### ##### ### ### # ### # ####### # # # # # # ##### # # ### #
# # # # # # # # #   # #   # #   # #     #   # # # # # #     # # #         # #       #   #   # #   # # #     # # # # # # #     # # #   # #
# # ### # # # ### # # # ### # # # ### # # # ### ### # # # ### # # ### ##### # ####### ##### ### ####### ####### # ##### # # # # ### ### #
# # #   # # #   # # # # #   # # #   # # # # #     # # # #   #       #               #     #   #               # #     # # # # #   #   # #
# # ### # # # # # ### # # # # # # ##### # # ### ### # # ####### # ######### ######################### # ######### ### # # ### ### ##### #
# #   # # # # # # # # # # # # # #     # # #   #   # # #       # #         #   #                     # #         #   # # #   #   #     # #
# # # # # ### # # # # # # # # # # # ##### ##### ##### # # ##### # # # ######### ####### # # # ####### ### # # ##### ##### ####### #######
# # # # #   # # # #   # # # # # # #     #     #     # # #     # # # #                 # # # #       # # # # #     #     #       #     # #
# ####### # # # ### # # # # # # # # # ### # ### ####### ### # # # ### ### # ##### # # ### # ########### ### ### # ####### # # ######### #
# #       # # # #   # # # # # # # # # #   #   #       #   # # # #   #   # #     # # #   # #               #   # #       # # #           #
# ### # # ### # ### # # # ##### # # ### # # ####### ### # # # # ##### ### # # # # ####### ########### ############# # # ### ### ##### # #
# #   # #   # #   # # # #   #   # #   # # #       #   # # # # #     #   # # # # #     # # #         #           # # # # # #   #     # # #
### # # # ### # # ### ### ####### ##### ### # ######### # # # ############# # # # ##### ### ### ### ####### ##### ####### # # # # ### # #
#   # # #   # # #   # #         #     # #   #         # # # #             # # # #             #   #       #               # # # #   # # #
### # ### ##### # # # # # # # # # # # # # # ### ####### # ### # # ### # # ### # ##### # # # ####### # # # ##### ### ####### ########### #
#   # # #     # # # # # # # # # # # # # # #   #       # #   # # #   # # #   # #     # # # #       # # # #     #   #       # #     # #   #
# # # # # ### ### ### # # ### # # # # ##### ### ##### # # ### ### ### # # # # ### ##### # # # # ##### ### # ### # # ### ##### ##### #####
# # # #     #   #   # # #   # # # # # # #     #     # # #   #   #   # # # # #   #     # # # # #   # #   # #   # # #   # #               #
# # # ### ### ### ### # # # # # # # ### # # # ##### # ####### # ##### # # ### ### # ### ### # ### # ##### # ####### # ### ##### ##### ###
# # # #     #   # #   # # # # # # # #     # #     # #       # #     # # #   #   # #   #   # #   #       # # #     # #         #     #   #
# # # # # ### # # ### ### # # # # ##### # # # ####### # # ### ### ####### ####### # # # ### # # # # # # ### # ####### ### ##### #########
# # # # #   # # #   # #   # # # # #     # # #       # # #   #   #       #       # # # #   # # # # # # #   #         #   #     #       # #
# # # ### # # ### # # ### # # ### ### # # # ### # # ### # # # # # ######### ####### # # ##### # # ### ### # ####### ##### ####### ##### #
# # # #   # #   # # # #   # # #     # # # #   # # #   # # # # # #         #       # # #     # # #   #   # #       #     #       #     # #
# ### # # # ### # # ### # # # ### # # # ### # # # ##### ####### # ####### # # ######### ######### # ####### ##### ### # # # # # # ##### #
# #   # # #   # # #   # # # #   # # # # #   # # #     #     #   #       # # #         #         # #       #     #   # # # # # # #       #
### # # # # ##### # # # # # # # ### # ### # # ### ############# ### # ##### # ########### # # # ### ##### # ### ##### # ### # # # #######
#   # # # #     # # # # # # # #   # #   # # #   #           #     # #     # #           # # # #   #     # #   #     # #   # # # #       #
# ### ### # ### # # ##### # # # # # # # ### ##### # # # # ##### # ### ### ### # ####### ### ### ######### # ### # ### ######### # ### ###
# #     # #   # # # # #   # # # # # # # #     # # # # # #     # # #     # #   #       #   #   #         # #   # #   #         # #   #   #
##### ### # # ### # # ### # # # ### # ### # # # ### ### # ####### ### # ##### # # # ### ### ##### # ##### ### # # ##### # ##### # # # ###
#       # # #   # #   #   # # #   # # #   # #     #   # #       #   # #     # # # # # #   #     # #     #   # # #     # #   #   # # #   #
##### ### # # # # # # ### # # # ### # # ### # # # ### ### ##### # ##### ####### ### # ##### # ##### # # ##### ### # ### # # ### # # ### #
#       # # # # # # # #   # # #   # # # #   # # #   #   #     # #     #       #   #     #   #     # # #     #   # #   # # #   # # #   # #
# # # # # # # # ##### ### ### # # # # # # # # # # # # ### # ### # # # # # ### ### # # # # # # # ### # ######### # # # # # ##### ### ### #
# # # # # # # # #       # #   # # # # # # # # # # # #   # #   # # # # # #   #   # # # # # # # #   # #         # # # # # #     #   #   # #
# # # # # # ### # # # # # # # # ### ### # # # # # ### # # # ##### # # # # ### ########### # # # ### # ### ##### # # # ### # ##### # # ###
# # # # # #   # # # # # # # # # #   #   # # # # #   # # # #     # # # # #   #           # # # #   # #   #     # # # #   # #     # # #   #
# # # # # ### # ### # # # ### ### # # # # # # ####### ### ##### # # # # # # ### ### # ### ### # ### # # # # # ####################### # #
# # # # #   # #   # # # #   # #   # # # # # #       #   # #   # # # # # # #   #   # #   #   # #   # # # # # #       # # #   # # #   # # #
# # ### # # # ### # # ### # # # # # ### ### # # ##### # # # ##### # # ##### # ######### ### ### # # # ### ########### # # ### # # ### ###
# # #   # # #   # # # # # # # # # #   # #   # #     # # #       # # #     # #     # # #   #   # # # # # #                           #   #
####### # ######### # # # # ####### # ##### # # ### # # # # ##### ### # ##### # ### # ############### # # # ################# # # ##### #
#       #         # #   # # #       #   #   # #   # # # # #     #   # #   # # #           #         #   # #     # #         # # #     # #
####### # # ### ### # ########### # # ##### # ### # # # # # ##### # # # # # ### # # # # # # ##### ######### # ### # ### ### # # # # ### #
#       # #   #   # #   #   #     # # #     #   # # # # # #     # # # # #     # # # # # #       #         # #         #   # # # # # #   #
##### # # # # # ### # # ### ### # # # ##### # ####### # # ##### # ### # # # ##### # # ### ####### # # ####### # ### ### # ####### #######
#     # # # # # #   # # # #     # # # #     #       # # #     # # #   # # #     # # #   #       # # #       # #   #   # #       #       #
### # ### ### # ### # # # ### # # # # ### # # ### # # # # ####### ### ### ##### # ############### ######### # ##### # ##### ##### #######
#   #   #   # # # # # #   #   # # # #   # # #   # # # # #       #   # #       # #               #         # #     # #     #     #       #
### # # # # # # # # # # ##### # # # # ### ### ############### # # # # # # # ##### # # # ### # ### ### # ##### # # ### ############# #####
#   # # # # # #   # # #   #   # # # #   # # #               # # # # # # # #     # # # #   # #   #   # #     # # #   #             #     #
# # # # # ### # # # # # # # # # ### # ##### # ##### # ### # # # # # # ### ####### ### ### ######### # # ### # # # ##### ##### # # ### # #
# # # # # #   # # # # # # # # # #   # # #   #   # # #   # # # # # # #   #     # # # #   #         # # #   # # # #     #   # # # # # # # #
# # # ### ### ### # # # # # # # ##### # ### # ### ### ####### ### ### ### ##### ### ### ### ### # ####### # ### ### ####### ####### #####
# # # #     #   # # # # # # # #   #   #             #       #   # #     #             #   #   # #       # # #     #                    x#
#########################################################################################################################################
