#########################################################################################################################################
#o                #         #           #                         #           #             #   #   #   #       #     #   # #   #   # # #
# ### ##### ####### ######### ##### ##### ####### # ########### ### ########### ##### ####### ### ### ### ### ### ####### # # ### ### # #
#   #     #             #         #             # #           # # #                 # # #   #   #   # #     #         # # # # #         #
# # # ##### # ##### # # # ####### ######### ### # # # # # # ### # # ##### ##### ### ### # ### ### ### # ### ########### # # # # ####### #
# # #     # #     # # #       # #         #   # # # # # # # # #       # #     #   # #                     #         # #   #           # #
# # # # ############# # ### ### ### ### ########### # ####### ######### ############# ############################# # # ### ### ### #####
# # # #             # #   #   #   #   #       # # # # #                     #                                 #   #   #       #   #     #
# # # ##### ### ### ########### ##### ######### # ### # ######### ########### ############################### # ####### ########### #####
# # #     #   #   #                 #     #   #     # #         #         #       # #       #   #           # #   #     #         # # # #
# ##### # ##### ### ### # ### # ######### # ### ####### ####### ##### # ### ####### # ####### ### ####### ##### ### ##### ########### # #
#     # #     # #     # #   # #         #                     #     # #           # #                   #         #                     #
# ### # # ######### ##### ##### # # # ### # # ############### # ##### ##### # ### # # ### # ########### ##### ##### ### ########### # # #
#   # # #     #   #     #     # # # # # # # #               # #     #     # #   # # #   # #     #     #     #     #   #           # # # #
# # ### # ### # ############### ####### ### ####### ####### ### ### # # ########### # ########### ################# ######### ###########
# #   # #   #         #       #   #   # # #       #     # # # #   # # #     #   # #                   #         #           #           #
# # # # # # ########### ####### ### ### # ############# # ### ############### ### # ### ### ### ####### ### ##### ### # ### ### ### #####
# # # # # #   # #             #   #   #         # # # #             #                 #   #   #           #         # #   # # #   # #   #
# # ### ####### # ################# ### ### ##### # # ############### ####### # ### # # ####### # # # # # # # # # ##### ##### ####### ###
# #   # # # #                             # # #             #     #         # #   # # #       # # # # # # # # # #   # #         # #     #
# ####### # # ######### # # ### ########### # # ### ####### # ##### ### ####### # ##### # # # # # # # ### ### # # ### ####### # # # #####
#                     # # #   #           #       #     # # #         #       # #     # # # # # # # #   #   # # #           # #         #
# # # # ##### # ### # ### ####### ### # ######### ####### ### ########### ##### ########### ### ### # ### # # # # ############# # ### ###
# # # #     # #   # #   #       #   # #         #         # #   # #     #     #           # #     # #   # # # # #         #   # #   # # #
# # # # # # # # # ######### ### ##### # # # ############### # ### # ##### ########### ######### ########### ### ### ### ### ### # ### # #
# # # # # # # # #   #   # #   #     # # # #           # #             #             #         #           #   #   #   #       # # # #   #
# ### # ##### # ##### ### ### ### ##### ### ##### ##### # ##### ##################### ####### # ######### ##### ### # # ######### # ### #
#   # #   #   #             #   #   # #   #     #             # #                 # #       # #       # # # # #   # # # # #     #     # #
# # ### ########### # ##### ##### ### ##### # ##### ######### ### ############# ### ### ####### # ##### ### # ### ####### # ########### #
# # #             # #     #     # #       # #     #         #               # #       #       # #       #       #     #               # #
# ### # ##### # ##### # ### ##### # ### ##### # ### # # ##### ##### ######### ########################### ##### ##### # ### # # ### ### #
# #   #     # #     # #   #     # #   #     # #   # # #     #   # # #                 # #         #           #     #     # # # # #   # #
# # # # # ##### # # # # ########### ########### ####### # ####### ### ################# # ######### ####### ##### # # ########### #######
# # # # #   #   # # # #                     # #       # #                                       #         #     # # #                   #
# # ### ### ### ### ### ### ######### ####### ##### ##### ### ### # # ####### ### # ##### # # ### ####### ### ### # # # # # ### ##### ###
# # #     #   #   #   #   #         #             #   # #   #   # # #       #   # #     # # #           #   #   # # # # # #   #     #   #
# # # # ##### ####### # # # # ### ##### ####### # ##### # # # # # ### ### # # # # # # # # ##### ### # ##### ### ### # # # # ##### ### # #
# # # #     #       # # # # #   # # # #       # #       # # # # #   #   # # # # # # # # #     #   # #     #   #   # # # # #     #   # # #
# # ### ### # # # ### # ### ### ### # ##################### # ##### ### # # # # ### # ### ##### ##### ##### # ######### # # # # # #######
# # #     # # # #   # # # #   #                           # #     #   # # # # #   # #   #     #     #   # # #         # # # # # #       #
# # # # # # # # # ####### # ### ### # # ############### # # # # # # ### ### # # ### ### ####### ####### # ########### # ### ### # #######
# # # # # # # # #         #   #   # # #               # # # # # # #   #   # # # # #   #       #       #             # #   # #   #       #
# # # # ### # # ### ####### # ### ### ##### # ### # # # # # # # # # ### ####### # ### # ### ### # # # # ### ### ### ####### ### # # #####
# # # #   # # #   #     # # #   # #       # #   # # # # # # # # # #   #       #     # #   #   # # # # #   #   #   #       # #   # #     #
# ##### ##### ### ##### # # # # # # # # ####### ### ######### # # ####################### # ### # # ##### # # # ##### # ### ### ### ### #
# #   #     #   #     #   # # # # # # #       #   #         # # #                       # #   # # #     # # # #     # #   # #     #   # #
##### # ### # # # # # # ### # # ####### # ######### ### ##### # # ##### # ### ##### ##### ### # ### ### ### # ### ##### # ### # # ### # #
#         # # # # # # #   # # #       # #         #   #     # # #     # #   #     #     #   # #   #   #   # #   #     # #   # # #   # # #
##### # # ### # ### # # # # # # # # ### ########### # ########### # ####### # # # ### ### ### ##### ######### ##### ##### ####### # # # #
#     # # # # #   # # # # # # # # #   #           # #         #   #       # # # #   # # #   #   #           #     #     #     #   # # # #
### # ### # ##### ##### # ### # # ##### # # ### ##### ####### ### ##### # # # # # ##### # ##### ### # ########### # ### ######### ##### #
#   # #         #     # #   # # #     # # #   #     #       #   #     # # # # # #       #     #   # #           # #   #       # #     # #
### # # # # # # # ### ########### # # # # # ####### ### ##### ####### ### # # ### ####### ### # ### # # # ### # ### # # ####### ####### #
#   # # # # # # #   #           # # # # # #       #   #     #       #   # # #   #       #   # #   # # # #   # #   # # #               # #
### ### # ### ##### ####### # ### ####### # ######### ### # ####### # # # # # # # # ##### ######### # ### # ##### ####### ############# #
#   #   #   #     #       # #   #     #   #       # #   # #       # # # # # # # # #     #     #   # #   # #     #     # #         #   # #
### # # # ### # # ##### ### # ### ### ### # # ##### ### # # # ### ### ### ##### # # # ######### ### ### ### ########### ####### ### #####
#   # # #   # # #     #   # #   #   # #   # # #       # # # #   #   #   #     # # # #             #   #   #                   #       # #
### ### # ### # ##### # ##### ########### # ### ##### # ############# ### # # ##### ####### ### # ### ### # # ##### ######### ######### #
#     # #   # #     # #     #         #   #         # #             #   # # # # #         #   # #   #   # # #     #         #           #
# # ### # # # # ##### ########### ### # # # ################### ##### ##### # # ### # ############# ####### # ### # # ########### # ### #
# #   # # # # #     #           #   # # # #             #     # #   #     # #     # #             #     #   #   # # #           # #   # #
# # # # # # # # ##### # ### ### # ####### # ### # ####### ##### # ########### # # # # ### ######### ####### # ######### ### # # ####### #
# # # # # # # #     # #   #   # #       # #   # # # #         #         #   # # # # #   #         #       # #         #   # # #       # #
# # ##### ### # # # # ### ### # ####### # # # ### # # ####### # # ##### # ########### # ####### ########### # # ##### ######### ##### # #
# #   #     # # # # #   #   # #       # # # #   #           # # #     #     #   #   # #       #           # # #     #         #     # # #
### ### # # # # ### # # # ### # ### ### # # # # # # ### ####### # # # # ### # ### ### # # # ### # ### # ##### ####### # ### ### ####### #
#     # # # # #   # # # #   # #   #   # # # # # # #   #   #   # # # # #   #         # # # #   # #   # #     #       # #   #   #       # #
# # # ##### # # # # ### # ##### # # ##### # # # # # # ##### ### # # ### # # # # ### ### ####### ##### # ##### ### # ### # # # # ### ### #
# # #   #   # # # #   # #     # # #     # # # # # # #         # # #   # # # # #   #   #     # #     # #     #   # #   # # # # #   #   # #
### # # # # ### # # # # # ##### # # ##### # # # # # # ######### # ########### ######### ##### ##### ### ####### ######### # ##### # # ###
#   # # # #   # # # # # #     # # #   #   # # # # # #         # #           #       # # #         # # #       #         # #     # # #   #
# # # # # # # # # ##### # ### ### # # # # # # # # ### ### # ##### ### ### ### # ##### ### ##### # ### # # ############### ##### ### #####
# # # # # # # # #     # #   #   # # # # # # # # #   #   # #   # #   #   # # # #     #         # # #   # #               #     #   #   # #
# # ### # # ### ### ### # # ### ####### # ##### # # # ######### ### ####### # # # ### ##### ####### ##### ####### ########### ######### #
# # #   # #   #   #   # # #   #       # #     # # # #         #   #         # # #         #       # #   #       # # #       #         # #
# # # # # # # # ####### # ##### # ####### ### # # ### # ####### ### # ### ########### # # ##### # # # ############# # ######### ### ### #
# # # # # # # #       # #     # #       #   # # # #   #     #     # #   # #         # # #     # #         #   #               # # #   # #
# ### # # # ### ### # ### # ### # ##### # # ### # ### # ##### ############# ############### # # # # # ##### ### ##### # ##### ### ##### #
# #   # # #   #   # #   # #   # #     # # #   # #   # #               #   # #             # # # # # # #             # #     #           #
# ### # ### # # ### ##### # ##### # # # # ##### # ### # # ##### ####### ### # ########### ######### ### ######### # ### ##### # # #######
# #   # #   # #   #     # #     # # # # #     # #   # # #     #                       # #         #   #         # #   #     # # #   #   #
# # # # ### ### # # # # # ##### # # ### # # ### # ####### # # ### # ######### # ##### # ### # ### ##### ### ### ##################### ###
# # # # #     # # # # # # #   # # # # # # #   # #       # # #   # #         # #     #     # #   # #       #   # # #     #       #     # #
# ##### ### # # ########### ####### # # ### ### # # # # # # ### # # # # ##### ### # ##### # # ##### ##### ####### # ##### ####### ##### #
#   #   #   # #                   #   # #     # # # # # # #   # # # # #     #   # #     # # #     #     #                               #
# ##### ##### # ##### # ### # ### # # # # # # # # # ### ### # # ### # # # # # # ### ####### # # ### ##### ### ##### ################# ###
#   #   #     #     # #   # #   # # # # # # # # # #   #   # # #   # # # # # # # #       # # # #         #   #     #   #             #   #
# ### # # # # # ############# # # ########### # # # ### ##### # # # # # # ### # # # # # # ### # ##### # ### ##### ##### ####### ##### # #
#   # # # # # #     #       # # #   #       # # # #   #     # # # # # # #   # # # # # #     # #     # #   #     #             #     # # #
# # ### ### ### # ### ####### ### ### ### ### ##### # # # # ### ### ### ####### ### ######### # # # # # ### ####### # ####### ###########
# # #   #   #   #           #   #       #   #   #   # # # #   #   #   #       # #         # # # # # # #   #       # #       #         # #
# ### # # # ### # ######### ####### ### ##### # ### # # # ##### # ### # # # # ### # # # # # ##### # ### ### # # # ######### ##### ##### #
# #   # # # #   #         #       #   #     # #   # # # #     # #   # # # # #   # # # # #       # #   #   # # # #         #     #       #
# # ### # ### # ##### ### # ### ### ##### # # # # # ### # ### # # # ### ### # # # # # # # # # # ####### # ### # # ### # # # # # # # #####
# # #   # #   #     #   # #   #   #     # # # # # #   # #   # # # #   #   # # # # # # # # # # #       # #   # # #   # # # # # # # #     #
# # # # # ##### # ### ##### # # # # ### ### # ### # # # # # # # # # # # # ### # # ######### # # ######### # # # # ### ### ### # # # # ###
# # # # # #     #   #     # # # # #   #   # #   # # # # # # # # # # # # #   # # #     #   # # # #       # # # # #   # #     # # # # #   #
# # ### # # # # # # # # # # ### ### # # # # # ######### # ### # # # # # # ##### # ##### ##### # # ########### # # ####### # ##### ### ###
# # #   # # # # # # # # # #   # # # # # # # #       #   #   # # # # # # # # #   #           # #             # # #       # #     #   #   #
### ### # ##### ### # ####### ### # # ############# ##### # # ### # ### ### ### ######### # ### # ########### # ############# ####### # #
#   #   # #       # #       #     # #           # #     # # #   # #   #       #         # #   # #           # #           # #       # # #
### # ### ### # ### # ##### ### ##### ####### # # ##### # # # # ######### ### ### ######### # # # # ############# ##### ### ########### #
#   # #     # #   # #     #   #     #       # #       # # # # #         #   #   #       # # # # # #             #     #               # #
# ### # # # # # ### # ### # # # # # # # ##### ### # # ### ######### ### # # # ### ##### # ##### ### # # ####### # ### # # # ##### ##### #
# #   # # # # #   # #   # # # # # # # #     #   # # # # #         #   # # # # #       #       # #   # #       # #   # # # #     #     # #
# # # # # ##### # # # # # ##### ##### # ### # ### # ### ####### # ### ### ### ### ########### ### # ### ### ##### ### # ### ######### # #
# # # # # # #   # # # # #     #     # #   # #   # #   #     # # #   #   #   #   #           #   # #   #   #     #   # # #           # # #
# ####### # # # # # # ### # # # # # # # ### # # # # ### ##### ### ### # # # # ### # # ### # ##### ### # ### ######### # ### ### #########
# #   #   #   # # # #   # # # # # # # #   # # # # #             #   # # # # #   # # #   # #     #   # #   #         # # #     #         #
# ### # # # # # ### # ######### # ### # # # # # # # # # # # ### # # ### ### # # ### # # # ### # # ##### # # ### ### ####### ### # #######
#   #   # # # #   # #       # # #   # # # # # # # # # # # #   # # #   #   # # #   # # # #   # # #     # # #   #   #     #     # #       #
# ### # # # ### ### # # ##### # ### # # # # ##### # # ##### # # ### ### # ### # ### # # # # # ### # # # ### # # # ####### # # # # # # ###
#   # # # #   #   # # #       #   # # # # #     # # #     # # #   #   # #   # #   # # # # # #   # # # #   # # # #       # # # # # # #   #
# ### # ### ### # # # ######### ####### # ### # # ### # # # # ######### # ### # ##### ### # # # # # ##### ### # # # ####### # ### ### # #
# #   # #   #   # # #     #   #       # #   # # #   # # # # #         # #   # #   #     # # # # # #     #   # # # #       # #   #   # # #
# ### # ### # # # # # # # # ### # # ### # # # ### # # # ### # # # ##### # ### ##### # ##### ### ### # ######### ### # ### ####### # # # #
# #   # #   # # # # # # #     # # #   # # # # #   # # # #   # # #     # #   #     # #     #   #   # #   #   # #   # #   #       # # # # #
# # ### # # ### ##### # # ####### # ### # # # # # # # ### # ####### # ### # # # ##### ### ######### ##### ### ######### # ### # # #######
# # #   # #   #   #   # #       # #   # # # # # # # # # # #       # #   # # # #     #   #         #                   # #   # # #       #
# # # # # # ### # ### ### # ############# # # ### # # # # # # ##### ##### # # ##### # ### # # ############### ### # # # ####### # # ### #
# # # # # #   # # #     # #             # # #   # # #   # # #   # # #   # # #     # # #   # #               #   # # # #       # # #   # #
# # ### ### ### # # # # # ######### ##### # # # # # ### ### # ### ### ####### # ### # # # ### # ####### ######### ### ### ##### # # #####
# # #   #     # # # # # #         #     # # # # # #   #   # #               # #   # # # #   # #       #         #   #   #     # # #     #
# ### # ### # # # # # ### # ##### ####### # ### # # # # ####### # # ### ### # ##### # ##### # # # # # # ######### # # # # # ##### # #####
# #   # #   # # # # #   # #     #       # #   # # # # #       # # #   #   # #     # #     # # # # # # #         # # # # # #     # #     #
# # # ### # # ### # # # # # # ### # # ### # # ##### # ####### ##### # ### ########### # ### # ##### ### ############# # # # ### ##### ###
# # #   # # #   # # # # # # # #   # #   # # # #     #       #     # #   #           # #   # #     #   #             # # # #   #     #   #
# # # # ### # ### # # # ### # ### # ##### # ##### # # # ### # # ### # # # # # ### ##### ##### # # # # # # ### ####### # #################
# # # # #   #   # # # #   # #   # #     # #     # # # #   # # #   # # # # # #   #     #   # # # # # # # #   #       # # #   # #       # #
##### ### # # # # # # # ### ##### ### ### ### # # # ### ### # # ### # ### ##### ########### # # # # ### # # ##### ####### ### # ##### # #
#     #   # # # # # # #   #     #   #   #   # # # # #     # # #   # #   #     #           # # # # #   # # #     #   #   # # #       # # #
##### ##### # ##### # # ### # ################### ### # ### # # # ### # ####### ########### ####### ##### # # # ##### ### # # ##### ### #
#     #     #   #   # #   # #     #   #         # #   #   # # # #   # #       #       # #         #     # # # # #   #     #       #     #
### # ### ### ##### # ############# ### ####### # ### # # ### # # # # ### # # # ####### # ### # ### ############# ### ##### ##### ### # #
#   # #   #     #   #                         # #   # # #   # # # # #   # # # #             # #   #                             #   # #x#
#########################################################################################################################################
