#########################################################################################################################################
#o                                  #   #                   #       # #   # #         #     #                       #   #   #           #
# ####### ####### ### ### ########### ### ### ####### # ### # ### ### # ### # ######### ##### ####### ################# # ### ###########
#       #       #   #   #                   #       # # # #     #         #           # #           #               #                 # #
# ### ### ####### # ##### ### ######### # # ### # ####### ########### ##### ####### ### # ####### # ##### ######### # ##### ########### #
#   #   #       # #     #   #   #     # # #   # #               # # #   #         # #           # #     #     #   # # # # #     # #     #
# # ######### ############### ### ##### # # # # # # ############# # ##### ######### # ########### ########### # ##### # # ####### # ### #
# #         #               # #       # # # # # # #                               #             #       # # # #   # #                 # #
# # ### # # # # # ######### ### ### ### ### # # # # ################### ############### # # ############# # ### ### # ####### ##### ### #
# #   # # # # # #         #       #   #   # # # # #                   # #             # # # #           # #                 #     #   # #
# ##### # ####### ### ### # # ##### ### ### ### ### ### # ####### ####### ### ####### ##### # ########### # ######### ##### ### # ##### #
#     # #       #   #   # # #     # # #   #   #   #   # #       #   # # #   #       #     #       # # # #     #   # #     #   # #     # #
# # # # # # # # ##### ########### ### ############# # ######### ##### # # ##### ##### # ########### # # # ##### ### #####################
# # # # # # # #     #           #             # # # #         # #   #         # #   # #         #     # # #                             #
# # # ### # # # # # # ### ####### ############# # ######### ##### ### ####### ### ### ### ####### ##### # # ##### ####### ###############
# # # # # # # # # # #   #       #                         #                 #       #   #     # #               #       # # #       #   #
# ##### ### # # # # # ##### # ##### ##### # # # ######### ######### # # # ##################### # ############# ####### ### # ####### ###
#         # # # # # #     # #     #     # # # #         #     #   # # # #               #     # #     #       #     # # #               #
# # ### ### # ####### ### # ### ############# ##### ########### ##### # ##### ### ####### ### # # ##### ############# ### ##### # ### ###
# #   #   # #       #   # #   #             #     #   # # #         # #     #   #       #   #                                 # #   #   #
# ### # ### # # # ### # # # ##### ### ######### ### ### # # ####### ##### ############### ############# ##### ### ####### # ### ##### ###
#   # #   # # # #   # # # #     #   #         #   #               #     #     #   #   #     #         #     #   #       # #   #     #   #
# # # # # ### # # ### # # # ### # ############# ##### ### ### ####### ######### ### ### ##### ### ### # ### ### # ### ### ### ###########
# # # # # #   # #   # # # #   # #     #       #     #   #   #       #   # # #                   #   # #   #   # #   #   #   #           #
# # ##### ### # # # # ### # ### # ##### ### ### # # # ##### ### ######### # # ######### # # # ### # # # # # ### ##### # # # #############
# #     #   # # # # #   # #   # #         #   # # # #     #   #     #                 # # # #   # # # # # #   #     # # # #             #
# # ##### # # # # ####### ### # # ### # # ### # # # # # # # ### ### # ### # # ### ##### ##### # # ### # # # # # ### # ### ####### #######
# #   #   # # # #       #   # # #   # # #   # # # # # # # #   #   #     # # #   #     #     # # #   # # # # # #   # #   #   #   #     # #
# # ##### # # # # ##### # # # ####### # # # # # ### # ### # ### # # # # # # # # # # ### ### ##### ####### ####### # ######### ####### # #
# #   #   # # # #     # # # #       # # # # # #   # #   # #   # # # # # # # # # # #   #   #     #       #       # #   #             #   #
# # # # ### # # # # # ##### # # ### # # # # ### # # # # # # # ### # # # ### # # # # ### ######### ##################### ######### ### # #
# # # # #   # # # # #     # # #   # # # # #   # # # # # # # #   # # # #   # # # # #   #         #   #           #               #   # # #
# # # ### # ##### ### ### ### ### ##### # # ### # ### # ##### # # # # # ####### ### ####### ######### ### # # ### ##### ### ### # #######
# # # #   #     # # #   #   #   #     # # #   # #   # #     # # # # # #     #     #       #     #       # # # #       #   #   # #       #
### ####### # ### # ### # ##### ##### ### # ##### ### # # # # # # ### # ####### # ############# # ############# ########### # ######### #
#       # # #   #     # #     #     # # # #     #   # # # # # # #   # #       # #             #                           # #         # #
### # # # # # # # # # # # ### # # ##### ### ##### ### ### # # # # ### # ### # # ### ### ####### # ##### ### # ##### # ######### ### #####
#   # # #   # # # # # # #   # # #         #     #   #   # # # # #   # #   # # #   #   #       # #     #   # #     # #         #   #     #
### ##### # # # # ####### # ### # # # ##### # # ### # # ##### # # ##### ### # # # # # # ##### # # # ### ### # # # # ### ### ######### ###
#       # # # # #       # #   # # # #     # # #   # # #     # # #     #   # # # # # # #     # # # # # #   # # # # #   #   #         #   #
# # # ### # # # # # ### ### ### ### ####### # # # ### ########### # ### # # ### ### ### # # ### ##### # ### # ### # ### ######### ### ###
# # #   # # # # # #   #   #   #   #       # # # #   #           # #   # # #   #   #   # # #   #       #   # #   # #   #         #   #   #
### # # # # # # # # # # ### ##### # # # # ##### ##### ##### # # ### # # ##### # # # ### # # # # ####### ##### # ### # # ####### ##### ###
#   # # # # # # # # # #   #     # # # # #     #     #     # # #   # # #     # # # #   # # # # #       #     # #   # # #       #     # # #
### # # ### # ### # ### # # # ##### # # # ########### # ### ### ### ### # # ##### # ##### # # ### # ############# ##### # ### ### # ### #
#   # #   # # #   #   # # # #     # # # #           # #   #   #   #   # # #     # #     # # #   # #             #     # #   #   # #     #
# # # # # ### # # ### # # ### # ######### ######### # # # # # # ### ### # ######### # # ### # ##### # ########### # # # ########### # ###
# # # # #   # # #   # # #   # #   #     #         # # # # # # #   #   # #         # # #   # #     # #           # # # #           # #   #
# ### # # ##### # ### # # # # ### # ### # # # # # ### # ####### # # ##### # ####### ### ##### # ### # ### # ### ##### ### ### ### ### ###
# #   # #   #   #   # # # # #   #     # # # # # #   # #       # # #     # #       #   #     # #   # #   # #   #   # #   #   #   #   #   #
# # # ### ##### # ### # # ### # # # ##### ### # # ####### # ### # # ##### # ### ##### ##### # # # ### ##### # # # # ########### # # # ###
# # # #     #   #   # # #   # # # #     #   # # #       # #   # # #     # # # #     #     # # # # #       # # # #             # # # #   #
# # # # # # ### ####### # # # ### # ########### # ##### # ####### # # # ### # ##### # # # ### # ##### ################### # #############
# # # # # #   #       # # # #   # #         #   #     # #       # # # #   #       # # # # #   #     #                   # #           # #
# # # # # # ### ####### ### # # # ################### # # # # ### # # ##### # # # # # # # # ### ### # # # # ####### # ### ######### # # #
# # # # # #   #       #   # # # #   # #       #     # # # # #   # # #     # # # # # # # # # #     # # # # #       # #   # #       # #   #
# ### # # # # # ######### # # # # ### # ####### ######### ######### ### ### # ### # # ####### # # ##### # # # ### # # ### # ####### # # #
#   # # # # # #         # # # # #                       #       #     #   # # # # # #       # # #     # # # #   # # #   #         # # # #
# # ##### # ######### # # # # # # ##### # ##### ####### # # # # # # # # # # ### ### # # # ##### ### ### ### # # ##################### # #
# #     # #         # # # # # # #     # #     #       # # # # # # # # # # #       # # # # #       #   #   # # #   #   # # # #       # # #
### ##### # # # # ### # ### ### # ### ### ##### ######### # # ##### # ############### # ### ### # # ### ####### # # ### # # # ####### ###
#       # # # # #   # #   #   # #   # # #     #         # # # #     #           #   # #   # #   # # #     #   # #                   #   #
### # # ### # ### # ### # # # # # ### # # # # # # ######### ##### # # ##### ### # ### ######### # # ### # # ########### # # # # ##### ###
#   # # #   #   # #   # # # # # #   #   # # # # #         #     # # #     #   #     #       #   # # #   #             # # # # #     # # #
# # # ##### # ### # ### # ##### # # # # # ####### ### ####### # # # # # ### # # # ############# # # # # # # ####### # ### ### ######### #
# # #     # #   # #   # #     # # # # # #     # #   #       # # # # # #   # # # #           #   # # # # # #       # #   #   #           #
# # # ### ### # # ##### # # ##### ##### # ### # # # ### ######### # # # ##### # # # # # ####### ### # # # # ### # # # ### # # # ### # ###
# # #   # #   # #     # # #   #       # #   #   # #   #       # # # # #     # # # # # #   #       # # # # #   # # # # #   # # #   # #   #
# # # # ### # ### # # # ######### ############### ### # # # # # ### # ### ##### ### # ### ### # # # # # # ### # ######### # # # ### #####
# # # #   # #   # # # #       #                 #   # # # # #     # #   #     # # # #   #   # # # # # # #   # #         # # # # #       #
### # # ##### ### # ### ####### # # ####### ### # ############### # # # ##### # # ### ####### # # # # # # ### ####### ##### ####### ### #
#   # #     #   # #   #       # # #       #   # #     # #   # # # # # #     # #     #       # # # # # # #   #       #     #     #     # #
### # # # ### # ### # ######### # # # # # # # ### # # # # ### # ####### ##### # # # # ##### # # ### ### # ##### # ################# #####
#   # # #   # # #   #         # # # # # # # #   # # #                 #     # # # # #     # # #   # #   #     # #                 #     #
# # # # ##### # # # ### ### ### # # ####### # # ########### # # ### ########### # ### # ####### ### ##### # # ##### ####### # # ### ### #
# # # #     # # # #   #   #   # # #       # # #           # # #   #           # #   # #       #   # #     # #     #       # # #   #   # #
# # # # # ### ### # # # # ### # # # # ##### ### ####### # ### # ####### # # # ############### # # ##### # # # # # # # # # ##### #########
# # # # #   #   # # # # #   # # # # #     # #       # # #   # #       # # # #               # # #   #   # # # # # # # # #     #         #
# # # # ### # # # ### # ### ### # # # # # # # # # ### ######### ############### ##### ### # # ### # ### ### # ### # # # # ####### #######
# # # #   # # # #   # #   #   # # # # # # # # # #             #   # # #     # #     #   # # #   # # #     # #   # # # # #       #       #
# # # # ######### # # # # # ### # ### # ### # # # ### # ##### # ### # # ##### ####### ##### ### ##### # # # # # ### # # # ### ####### ###
# # # #         # # # # # # # # #   # #   # # # #   # #     # #                     #     #   #   #   # # # # #   # # # #   #       #   #
# ### # # # # # # # # # # # # # # # ### ### # # # ### # # # # # # ########### # # ### ### ### # # # # ##### # # ### # # # ##### ### # # #
#   # # # # # # # # # # # #   # # #   #   # # # #   # # # # # # #           # # #   #   #   # # # # #   #   # #   # # # #     #   # # # #
# # # # ### # # # # # # ### ### # # ### ### # # # # # ### # ####### # ### ### ### ### # # ##### ##### ### # # ####### # # ### ##### # # #
# # # #   # # # # # # #   #   # # #   #   # # # # # #   # #       # #   #   #   #   # # #     #   #     # # #     #   # #   #     # # # #
# # # # ##### ### # # ##### ### # # ### ### ### ### # # ######### # # ######### ####### # ##### ### # ##### # # # ### # # ##### # # ### #
# # # #     #   # # #   # #   # # #   #   #   #   # # # #       # # #         # #     # #     # # # #   #   # # #   # # #     # # #   # #
# # # # # # # # # # # # # # # # # # # # # ### # ### # ### ######### ### # ### ### ######### ##### ### ##### # # # # # # # ### # ### # # #
# # # # # # # # # # # #   # # # # # # # #   # #   # #           #     # #   #             #         #     # # # # # # # #   # #   # # # #
# # ### # # # # # ### ##### ##### ### # # # # # ### # ### ### # ### ### # ################# ### # ### # # ### ### ### # # # # # ####### #
# # #   # # # # # #       #     #   # # # # # #   # #   #   # #   #   # #                 #   # #   # # #   #   #   # # # # # #       # #
# # ### # ##### ##### ########### # # # # # # # # # # ##### ### # ### # ### # ####### ### # ### ####### ### # ######### # # ### # # # ###
# #   # #     # #               # # # # # # # # # # #     #   # #   # #   # #       #   # #   # #     #   # #         # # #   # # # #   #
### ##### # ### ### # # ############### ### ### ### # # # # ####### # # # # ##################### ######### # # # # ####### # # # # ### #
#     #   #   # #   # #               # #   #     # # # # #       # # # # #           # #     #       #   # # # # #       # # # # #   # #
# # ##### # ####### # # ### ### ### ### # # ### # # # # # # # ### ### # # # # ### ##### # ##### ### ### ########### ### ### ### # # # ###
# #     # #     #   # #   #   #   #   # # # #   # # # # # # #   #   # # # # #   #                 #       # #   # #   #   #   # # # #   #
# # ##### ### # ### # # # # # # ### # ##### ### # ##### ### ### # ##### ### # # ########### # ### # ##### # # ### ####### ##### ### # # #
# #     #   # # #   # # # # # #   # #   # #   # #   #     #   # # #   #   # # #   #       # #   # #   # #               #     #   # # # #
### ### # # ### ### ### ####### ### ##### # # # ### ### ### ####### ####### # # # # ######### ######### ############### # ### # # ### # #
#     # # #   # #   #         #   #   #   # # #   # #     #           #   # # # #         # #                         # #   # # #   # # #
# # # # # # ### # # # # # ############# ### ### # # # # ### # ##### ### ##### # # ####### # ############# # ####### ########### ##### # #
# # # # # #   # # # # # #     # # #     # #   # # # # # #   #     #       # # # #       #               # #       #           # #   # # #
# # # ### # # # ### # ### ##### # # ### # ##### # # # # # # # # # # ##### # # # # # ##### ### # ### ### # # ################# ### ### # #
# # #   # # # # #   # #         #     #       # # # # # # # # # # #     #   # # # #     #   # #   #   # # #             # # #       # # #
# # # # # # ### # # # # # # ##### ### # ### ######### ### # ### ############### ### ### # ##### # # ####### # # # # # ### # ####### #####
# # # # # # #   # # # # # #         # #   #         #   # #   #               #   #   # #     # # #     #   # # # # #             #     #
# # # # # # ### ##### # # # # # ##### # # ### ####### ### # # # # ### ########### # # # ####### # ### # ### ### # ####### # # ### # # ###
# # # # # # #     #   # # # # #     # # #   #   #   #   # # # # #   # #         # # # #       # #   # #   #   # #       # # #   # # #   #
# # # # # # # # # ### # # ### # # ####### ####### ####### # ### # ##### ### # ####### ### ##### ##### ##### ##### ####### ### ### ### # #
# # # # # # # # #   # # # #   # #       #               # # #   #         # #       #   #     #     #     #     #       #   #   #   # # #
# # # # # # ### # # # # # ### ### # # ### ####### ##### # # ### # # ######### # # ### # ### ### ##### # # # # ### ##### ########### #####
# # # # # # #   # # # # #   #   # # # #         # #   # # # #   # #         # # #   # #   #   #     # # # # #   #     #           #     #
# # # # # # ### # # # # ### # ### ### # # ### ##### ####### # # # # # # ### ### # ### # # # ### # ### # # # # # # # ##### ####### ##### #
# # # # # #   # # # # #   # #   #   # # #   # #           # # # # # # #   #   # #   # # # #   # #   # # # # # # # #     #       #     # #
# # # ##### # ### ### ### ### ### # ### # # # # ############### ### # # # ##### # # # # # # ### ### ######### ### # # ### ##### ##### # #
# # #   #   # #     #   # #     # #   # # # #     #         #     # # # #     # # # # # # #   #   #         #   # # #   #     #     # # #
# # # ##### ##### ### # ### # ### # # # # ### ##### ########### # # ### ### # # # # # # # # # # # ####### ### ##### ##### ####### ### # #
# # # #       #     # #   # #   # # # # #   #               #   # #   #   # # # # # # # # # # # #       #   #     #     #       #   # # #
# ### # # # # # # # # # # ### # # # # ### ### # # ### # # ##### # # # # # # # # # ### ### ### ######### ### ####### # # # # # # #########
# #   # # # # # # # # # # #   # # # # #     # # #   # # #   #   # # # # # # # # #   #   #   #         #   #       # # # # # # #         #
# ### # ### # ### # # ### ### # ### # # # # # # ### # # ####### ### # # ##### ####### ### # # # # ####### ##### # # ### # ##### ### #####
# #   # #   #   # # #   # #   # #   # # # # # #   # # #       #   # # #     #       #   # # # # # #     #     # # #   # #     #   #     #
# # # # # # # # # # # ##### ### ### # ### # ### # ##### # ### # # # # # # # # # # # # ##### # ### # ### # # # # # # ### # ### # # # #####
# # # # # # # # # # # # # # #   #   #   # #   # #     # #   # # # # # # # # # # # # #     # #   #     # # # # # # #   # #   # # # #   # #
# # # ### # # ### # # # # ### # # # # ### # # # ### # ######### ### ### ##### # ### # # ##### # # # ##### # # ####### ### # ### ### ### #
# # # #   # # #   # #       # # # # #   # # # #   # #         #   #   #   # # # #   # #     # # # #     # # #       # # # #   # # #     #
# ### ### # ### # ### # ##### # # # # ### # # # # # # ####### # ### ### # # # ### # # # # ### ### # ### # # # # ####### # ####### ##### #
# #   #   # #   #   # #     # # # # # #   # # # # # #       # #   #   # #   #   # # # # #   #   # #   # # # # #         #       # #   # #
# # # # # # ### # ### # # ### # # # # # # ##### # # # ##### # # ####### # # # # # # # # # ### ### # ########### ############# ### # #####
# # # # # #   # # #   # #   # # # # # # #     # # # #     # # #       # # # # # # # # # #   #   # #         # #     # # # # # #         #
##### # # # # # ##### # # ### # # # # # # # ##### ### # # # ##### # ### # # # ######### # ##### ### ######### ####### # # # ### #########
#     # # # # #     # # #   # # # # # # # #     #   # # # #     # #   # # # # #     # # #     # # #           #                         #
####### ### ### ##### ####### ##### ##### ####### ### # # ### ##### # # ####### ##### ########### ### ######### ######### # #############
#       #     #   #         #   #     #         #   # # #   #     # # #                             #                   # #            x#
#########################################################################################################################################
