#########################################################################################################################################
#o  #   # #             #   #       #       #     #         #     #                 #                   #         #         #   #       #
# # # ### # ### # ####### ### ##### # ####### ##### ######### ##### ################# ######### # ####### ### ### # ######### ### ### # #
# #           # #     #   #       #               #                 #           #   #         # #           #   # #   #   #       # # # #
# # ### # ############# ### ############# ######### ### # ########### ########### ### ### # ### ############### ### ### ### ### ### #####
# #   # #     #                       # # #   #       # #                     #         # #   #       #   #   #     #         #         #
# # # # # # ### ####### # ### # # # ### ### ### ##### ########### # ### ####### ####################### ### ######### ####### ######### #
# # # # # #           # #   # # # #                 #           # #   #     #   #   #                                     # #         # #
# # ### # ####### ### ### # ### # # # ######### # # ### ##################### ### ### ####################### ############# ##### #######
# #   # #       #   #   # #   # # # #         # # #   #             # #   #                       # #       #             #     #       #
# # ### # ### ##### ##### ### ##### ##### # # # ### # # ############# # ### ########### ########### # ######### ########### #############
# # #   #   #     #     #   #     # #   # # # #   # # #           #   # #             #         #         # # #           #       #   # #
# # ### # # # ### # # ### # # # # ### ########################### # ### # ##### ##### ### ####### ### # ### # ######### ### ### # # ### #
# #   # # # #   # # #   # # # # #                   #           #             #     #   #           # #             # #       # #       #
# # # # # ### # ### ### # # ########### ### ##### ### ######### # # ### ### # # ### ### ### # ######### ##### # # ### ##### # ### # #####
# # # # #   # #   #   # # #           #   #   # #           # # # #   #   # # #   #   #   # #         #     # # # # #     # #   # #     #
# # ##### # # # ####### # # ### ### ### ### # # ########### # ### # ### # ### # ##### # # # # ######### # # ####### # ### # ### ### ### #
# #     # # # #       # # #   #   #   #   # #     # # # # #     # #   # # #   #     # # # # #         # # #             # #   #   #   # #
# # # # # # # # ### ##### # # ##### # ####### # ### # # # ####### ### # # ### # ### ### # # # ##### ##### # ######### ### ### # # # ### #
# # # # # # # #   #     # # #     # #       # #                 #   # # # # # #   #   # # # #     #     # #         #   # # # # # #   # #
# # # ### # ### # ##### # # ### ############# ### ##### # # ####### ### ### # # ##### # ##### # # # # ##### # ##### # # ### ##### # #####
# # #   # #   # #     # # #   #             #   #     # # #       #   #     # #     # #     # # # # #     # #     # # #         # #     #
# ### # # ##### # ### ##### ### # # # ######### # # # # # # ##### ####### # # # ##### # ##### # # ### # # ### # # # # ##### # # ### #####
# #   # #     # #   #     #   # # # #         # # # # # # #     # #     # # # #     # #     # # #   # # #   # # # # #     # # # # #   # #
# ### # ####### # # # # ### ### # # ### ####### # # # # ### ### ### ### # ##### # ### # # ### # # ##### # # # ### # ####### ##### ### # #
#   # #       # # # # #   # #   # #   #       # # # # #   #   #       # #     # #   # # #   # # #     # # # #   # #     # #   #     # # #
# ### # ##### ### ##### ### # # ### # ### ############# # ##### # # # ### ### ##### ### # # # # ### ### # # ######### # # ##### ### # # #
# #   #     #   #     #   # # #   # #   #   #         # #     # # # # # #   #     #   # # # # #   #   # # #         # #           # #   #
### # # # # # ### ##### # # ### ### # # ##### ##### ##### # # ##### # # # ##### # # # # # ### # ####### # # # ######### # # # # # ##### #
#   # # # # #   #     # # #   #   # # #           #     # # #   # # #   #     # # # # # #   # #     # # # # #         # # # # # #     # #
# # ### # ####### # # # ### # # # # # # # # ############# # # # # # # # # # ### # # # ### # # ### ### ### # # # ####### ##### # # # # # #
# #   # #       # # # #   # # # # # # # # #             # # # #   # # # # #   # # # #   # # #   #   #   # # # #       #     # # # # # # #
### ### # # ##### # # # # # # # ### # # # # # # ### ### # # # # ##### # # ##### # # # ##### # ### # # ##### ##### ### # # ### ### # ### #
#     # # #     # # # # # # # #   # # # # # # #   #   # # # # #     # # #     # # # #     # #   # #       #     #   # # # #     # #   # #
### # # # # # # # ### ##### # # ### # # ### # ##### # # # # ### # # # # # ####### ########### ##### ### # # ####### # ##### # # # #######
#   # # # # # # #   #   #   # #   # # #   # #     # # # # #   # # # # # #       #           #     #   # # #       # #   #   # # #       #
# # # ### # # ### ##### ### # # ### # # ##### # ####### # # # # # ### # # ############# # # # ### # ### ### # ### ### # ####### # #######
# # #   # # #   #     # #   # #   # # #     # #       # # # # # #   # # #             # # # #   # #   #   # #   #   # #     #   #       #
# # # # # ### # ### ####### ### # # # ### # ### # # ### # # ### ### ### ### # ######### ##### ### # ##### # # ### ########### # #########
# # # # #   # #   #       #   # # # #   # #   # # #   # # #   #   # #     # #         #     #   # #     # # #   #           # #         #
# # ##### ### ##### ####### ### # ### ### # # # ### ####### # ### # # # ##### ### ####### ### ##### # ##### # # ####### ####### ##### ###
# #   #     #     #       #   # # #     # # # #   #       # #   # # # #     #   #       #   #     # #     # # #       #       #     #   #
### # ### # # # ################# ### # ### # # ### # ### ######### # # # # ########### ##### # # ######### # ### ### # ### ### #########
#   # #   # # #                 # #   #   # # #   # #   #         # # # # #           #     # # #         # #   #   # #   # #       # # #
# # ##### ### # # ### ########### # # # # # ### # # # # ### # ##### ### ### # ### # ### # # ##### ### ### # # ### ########### # # ### # #
# # #       # # #   #         #   # # # # #   # # # # #   # #     #   #   # #   # #   # # #     #   #   # # #   #           # # #     # #
# # ### # ### # # ### ####### ### # # # # # # # ### # ### ### # ### # ### # # # # ### ####### # # # ### # # ### # # # ######### # # # # #
# # #   #   # # #   #       #   # # # # # # # #   # #   #   # #   # #   # # # # #   #       # # # #   # # #   # # # #         # # # # # #
# # ### # # ### ### # # ### # ### # ### ##### # ##### ######### ########### # # # ############### # # # ### # # # ##### ### ### ### # # #
# #   # # #   #   # # #   # #   # # #       # #   #     #     #         #   # # #               # # # #   # # # #     #   #   #   # #   #
# # # # # # ### # # # # ######### # # # # ##### ####### # ### # ### ### ### ### # ### # # ### ##### ### # ####### ##### # ##### ### # # #
# # # # # #   # # # # #         # # # # #   #         #     # #   #   #   # #   #   # # #   #     #   # #       #     # #     #   # # # #
# # # # # # # # ### ### # ### ##### # # # # ### # # # # # ####### # ### ### # # # # ##### ########### ########### # ### # # # # # ##### #
# # # # # # # #   #   # #   #     # # # # # #   # # # # #       # #   #   # # # # #     #           #           # #   # # # # # #   #   #
# # # # # ### # # # ### # ##### ##### ### # ### ### ### # # # # # # # # ### # # # ##### # # ####### ### # # # ### # ### # # ### ##### # #
# # # # #   # # # # #   #     #     #   # #   #   #   # # # # # # # # #   # # # #     # # #       #   # # # #   # #   # # #   #   #   # #
# # ### ##### # # # # # # ##### ### # # # # ### # # # # # ### ######### # # # # # ### # # ##################### # # ########### ####### #
# # #       # # # # # # #     #   # # # # #   # # # # # #   #         # # # # # #   # # #                     # # #   #       #     #   #
# # ### # # # # # # # # # # # # # # ### # # ### # ### ### # # ### ##### # # ### # ### ##### ### ### # # ####### ### ### ##### # ####### #
# # #   # # # # # # # # # # # # # #   # # #   # #   #   # # #   #     # # # #   #   #     #   #   # # #       #   #         # # # #     #
# # ### # # # # ### ### ### ### ### ##### # # # # ### # # ### ### ### # ### # # ### ### ########### # # ##### ############### # # ##### #
# #   # # # # #   #   #   # #     #   #   # # # #   # # #   #   #   # #   # # #   #   #           # # #     # # #   #       # # # #     #
### # # ##### # ####### ####### ### ##### # # # # # ##### ##### # # ### ### # # ### ### ##### ######### ##### # # ### ########### # # # #
# # # #     # #       #     #   # #     # # # # # #     # #   # # #   #   # # #   # #       #         #     #               #     # # # #
# # ### ### # # ### ### # ### # # ### # # # # # ### # # # # ######### ### # ### # # ### # # # ######### ##### # ### ### ##### ####### ###
#   #     # # #   #   # #   # #     # # # # # #   # # # #           #   # # #   # # # # # # #         #     # #   #   #             #   #
# # ### ### ### # # ### # ##### # # ### ### # # ### # # # # # # # # ##### # ### ##### ####### ### ####### # # ####### # ####### # ### ###
# # #     # #   # #   # #   #   # # # #   # # #   # # # # # # # # #     # # # #             #   #       # # #     # # #       # #   # # #
# # # # ##### # # ### # # ### # # # # # # # # # # # ### # # ####### ##### ### # # ### # # ### # # # # ######### ### ####### # ##### # # #
# # # #     # # #   # # #   # # # # #   # # # # # # #   # #       #     #   #   #   # # #   # # # # #         #           # #     # #   #
# # # # ######### ### ### ### # ####### ### # ##### # # # ##### ### ##### ### # # ### # # ##### # # # # ##### # ##### ### # # # ##### # #
# # # #       # #   #   # #   #     #     # #   #   # # #     #   #     # #   # #   # # #     # # # # #     # #     #   # # # #     # # #
# ##### # # # # ### # # # # # # ### ### # ### ##### # # ####### # # # # # # # # # # ### ##### # ### # ### ### # ########### ### # # # # #
# #     # # #     # # # # # # #   #   # #   # #   # # #       # # # # # # # # # # #   #     # # # # #   #   # #         # #   # # # # # #
# ### # ### ### ##### # ##### # # # # ### ### # ##### # # ### ### # # ##### # ### # # # ### ##### ##### # ##### # ####### # ### # # # # #
#   # #   #   #     # #     # # # # #   # #         # # #   #   # # #     # #   # # # #   #           # #   #   #       # #   # # # # # #
# ##### ### # ######### ### ##### # # ### ### # # ### # # # ### ######### ### ### # ### ### # # ######### # ### # # ##### ####### # # ###
#   # #   # #         #   #     # # # #   #   # # #   # # #   #     #   # #     # #   #   # # #         # # #   # #             # # #   #
# # # # ##### # ### # # # # # ### # # ##### # ### ### # # # ### # # # ####### ### # # ######### ##### # ####### # ######### # ### ### ###
# #   #     # #   # # # # # #   # # #   #   #   #   # # # #   # # #       #     # # #         #     # #       # #         # # # #   #   #
# # ### # ### # # # ### ##### # # # # # # # # ### # # ### # ### # # # # # ### # # ####### # # # # # # ### ##### # ### # ##### # # # # ###
# #   # #   # # # # # #     # # # # # # # # #   # # #   # #   # # # # # # #   # #       # # # # # # #   #   #   #   # #     #   # # #   #
# # # # # ### # ##### # ##### # # # ### ### # # ### # ### # # ##### # # # ### # # ####### ##### # # ##### # ### # # ### # ####### ### ###
# # # # #   # #       #     # # # #   #   # # #   # #   # # #     # # # #   # # #       #     # # #     # # #   # #   # #       #   #   #
##### # # ##### ### # ##### # ### # # # # # # ####### ##### # # ##### # # # ### # # ### ### ##### # # ##### ### # # # # ### ### # # # ###
# #   # #     #   # #     # #   # # # # # # #       #     # # #     # # # #   # # #   #   #     # # #     #   # # # # #   #   # # # #   #
# # ##### # # # ### # # # ##### ### # # # ### # ##### ##### ### # ####### # # ##### # # # ####### # # ### # # # # # ### # # # ### #######
#   #     # # #   # # # #     #   # # # # #   #   # #     #   # #   #     # #   #   # # #       # # #   # # # # # # #   # # #   #     # #
### # # # # # # # # # # ##### ######### # ### # ### # # ### # # ####### # # # # # # # # # # ### # ### # # ####### # ### # ######### ### #
#   # # # # # # # # # #     #       #   # #   #     # #   # # #       # # # # # # # # # # #   # #   # # #       # # #   #         #   # #
# # # # # # # # # # ### ### # # ### ### # ### ### # # # # ####### ##### # # ##### # # ### # # ##### ##### # ##### # # # ##### # ### ### #
# # # # # # # # # #   #   # # #   #   # #   #   # # # # #       #   #   # #     # # #   # # #     #     # #     # # # #     # # # # # # #
##### # ### # # # # # # # ####### ### # # ### ####### # # ########### # # # ### ### ### # # # # # # # # # # # ##### # # ### # ### ### # #
#     #   # # # # # # # #       #   # # # #       # # # #   # #     # # # #   #   #   # # # # # # # # # # # #   #   # #   # # #     # # #
##### # # # ### # # # # # # ####### ### # ### # ### ##### ### # ####### # # # ##### # # ### # # # # # # # ########### # # # ### ##### # #
#     # # #   # # # # # # #       #   # # #   #       #               # # # #     # # #   # # # # # # # #           # # # #         #   #
# # # # ### # ##### ### # ### # # ####### ### # # # ##### # ######### # # ### ##### ### ### # # ### ### # ####### # ### # ####### ### ###
# # # # #   #     # #   #   # # #       # #   # # #     # #         # # #   #     #   #   # # #   #   # #       # #   # #       #       #
######### # # # # # ### # # ### # # # ### # # # # # ##### ### ### # # # # # # ### ### # ##### # ### # # # ######### ### # # ##### # # # #
#         # # # # #   # # #   # # # #   # # # # # #   #     #   # # # # # # #   #   # #     # #   # # # #         #   # # #   #   # # # #
# # # ### # # # # ### # # # # ### ####### ### ### # # ### # # ### ### ### ####### # # # ### # ##### ### ##### # ####### # # ##### # #####
# # # #   # # # #   # # # # #   #       # #   #   # #   # # #   #   #   #       # # # #   # #     #   #     # #       # # #   #   #     #
####### # # ### # ### # # # ##### # ############# # ##### ### # ### # ### # # ##### ### # # ### ### ### # # # ### ####### # # # # # #####
#       # #   # #   # # # #     # #       #       #     # # # #   # #   # # #     #   # # #   #   #   # # # #   #       # # # # # #     #
# # # ### # ### # # # # ##### ##### ### ######### # ####### ######### ### # # # ######### # ### ##### # # ### ### # ##### ### ### # # # #
# # # #   #   # # # # #     #   #     #   # #     #     #         #     # # # #         # #   #     # # # #     # #     #   #   # # # # #
# # # ### # # # ### ### ##### ### # # # ### ### # # ### # ##### ### # # # ######### # ### ####### ##### ##### # ### # ### ### # # # # # #
# # # #   # # #   # #     # # # # # # #     #   # #   #       #   # # # #         # #   #       #     #   #   #   # #   #   # # # # # # #
### # # # # ### ### ### # # ### ### # ### # # ### # # # # ### ### ### # # ##### ### # ### # ### ### # # # ### # # # # # ### # ### ### # #
#   # # # # #     #   # #         # #   # # # #   # # # #   #   #   # # #     #   # #   # #   #   # # # #   # # # # # #   # #   # #   # #
# # # ### ### # # ### # # ##### # ### ### # ### # # # # # # # # ####### # ### ### # # ### # # # ##### ##### # # # ### ########### # # ###
# # # #   #   # #   # # #     # #   #   # #   # # # # # # # # #     # # #   #   # # #   # # # #     #     # # # #   #           # # #   #
# # # # # # # # ### ### # ### # ### # ########### # # # # ### # # ### ##### # # # # ##### ### # # # # ### ### # # # # ####### ### # # ###
# # # # # # # #   # #   #   # #   # #           # # # # #   # # #   #     # # # # #     # #   # # # #   #   # # # # #       #   # # #   #
### # ### # # # # ### ### # # # ########### # # # # # ### ##### ### # ### # ##### ######### # # # # # # ### # ### # # ### # ##### ### ###
#   # #   # # # # #   #   # # #           # # # # # #   #   # #   #     # #     #         # # # # # # #   # #   # # #   # #     # #     #
### # # # # # # # ### # # # ### ### ##### ### # # # # ### # # # # ### ########### # ### ### ### # ##### # # # # # # # # # ##### # # # # #
#   # # # # # # #   # # # # #     #     #   # # # # #   # # #   #   #         # # #   #   #   # #     # # # # # # # # # #     # # # # # #
# # ##### ### ##### ### # # # # # ### ##### # # ### # ### # ### # ### ######### ##### ### # ##### ####### # # # # ### # # ####### ### ###
# # #       #     # #   # # # # #   #     # # #   # #   # #   # #   #               #   # #   #         # # # # # #   # #       # #     #
##### ### ### ### ### ### # # # # # ##### ##### ### # # # # ### # # # ##################### ##### # # # # # # # # # # ### # # # # ### # #
#     # # # #   #   # #   # # # # #     #     #   # # # # # #   # # #                     #     # # # # # # # # # # #   # # # # # #   # #
### ### # # # ####### ### ### # ### # # ##### ##### # # ### # # # # # # ####### ####### ######### ### # # ### # # # # ### ##### # # # ###
#   #     #         # #     # #   # # #     #     # # #   # # # # # # #       #       #         #   # # #   # # # # #   #   # # # # #   #
########### # # ### ##### # ### ### # # # ##### # ### # # # # # # # # # # # # # ### ##### ####### ##### ### # # # # # # # ### ####### # #
# #   #     # #   #     # # #     # # # #     # #   # # # # # # # # # # # # # #   #     #       #   # #   # # # # # # # #           # # #
# ### ##### # ### # ##### ### # ### # # ### ### # ##### # ### # # ### ### # # ##### # # # ##### # ### # # # ##### ##### # ####### ### # #
#           #   # #     #   # # #   # #   #   # #     # #   # # # # #   # # #     # # # #     # #     # # #   # #     # #       #   # # #
# ####### ### ######### # ### # ### ### # ### ##### ##### # ### ### # # ### # # # ### ### ############### ##### # ##### # # ##### #######
# #       #           # # #   # #     # #   #     #     # #   #     # # # # # # #   #   #             # #       #     # # #     #       #
# # ### # ### # ##### ### # # # # # # # # ##### # # ##### # # # # # # # # ### ### ################# ### ##### ##### ##### ######### # # #
# # #   # #   #     #   # # # # # # # # #     # # # #   # # # # # # # # # #     #             #   # #       #     #     #         # # # #
# ### # # # # # # ############# ### # # # # # # ##### ##### ### ##### ### ### # ####### ####### ##### ### ### ############### ###########
# #   # # # # # # #           #   # # # # # # #     #     # # # #   #       # #     # # #     # #       # # #               #           #
### # ##### # # ### ##### ####### # # ### # ######### ####### # ### # ### ### # # # # ### ##### # ######### ############# # ##### # # ###
#   # #     # #         #       # # #   # #                   # #       #   # # # #                                     # #     # # #  x#
#########################################################################################################################################
