#########################################################################################################################################
#o#                           #       # # #     # # #         # #                   # #                     #   # # #         #     # # #
# # ### ######### # ########### ####### # # ### # # # ######### # ######### ### ##### # ########### ### ### # ### # # ######### ##### # #
#     #         # #           #               # #                 #       #   #                   # # # # #   # #   # #     # #       # #
# # ##### # ####### ##### # ### ### # ### # ##### ################# ####### ####### # # ##### ####### ### ##### # ### # ##### # ####### #
# #     # #       #     # # #     # #   # #                             # #       # # #     #     #   # #                             # #
# # # # # # # # ########### # ### ### # # ### # ### # # ### ##### # # ### ####### ### # ##### ##### ### # ############### # ### ####### #
# # # # # # # #           #     # # # # #   # #   # # #   #     # # #           #   # #   # # # #   #                   # #   # #       #
# # # ####### ##### # ### ##### # # ### ### ### ### # # # ####### # ####### ############### ### # ### ######### ### # # ### ### # ### ###
# # #       #     # #   # # # # #     #   #   #   # # # #       # #       #   #     #     # #                 #   # # #   #   #     #   #
# # # ############### ##### # ####### ### # ### ##### ####### ##### # ### ##### ##### ##### # ##### ### # # # # ### # ### ### # # #######
# # #   #           #               # # # #   #     #       #     # #   # # # # # # # #           #   # # # # #   # #   #   # # #       #
# ### # # ####### ##### # # # # # ##### ######### ### ##### ####### # ##### # # # # # # ######### # ############# # # ### ####### ##### #
# #   #         #     # # # # # #               # #       #     #   #   #                       # #             # # #   #     # #     # #
# ### # # # # ### ### ### ##### # # ### # ##### ##### # # ############### ####### ####### ##### ##### # # ### ### ### # ####### ##### ###
#   # # # # #   #   #   #   # # # #   # #     #     # # #               #       #       #     #     # # #   #   #   # #             #   #
# ### # # # ### # # ##### ### ########### ### ### # # # # ### ### ####### ####### # # # # # ##### # # # ### # ### ##### # ### ###########
#   # # # #   # # #     #       #       #   #   # # # # #   #   #               # # # # # #     # # # #   # #   #     # #   #           #
# # # # # # # ##### ##### # ### # ####### ### ### # # ### # # # # ##### # # ##### # # # # ####### # # # # ############### ### # ### # # #
# # # # # # #     #     # #   #         #   #   # # #   # # # # #     # # #   # # # # # #       # # # # #               #   # #   # # # #
# ### # # # # ########### # ##### # # ### ########### # # # # ### # # # # # ### # ##### ### ##### ##### # # ####### ##### ### ##### # # #
#   # # # # #           # #     # # #   #           # # # # #   # # # # # #     #     #   #     #     # # #       #     #   #     # # # #
# # ### # # # ### ########### # ### # ######### ### # # # # # # # ##### # ### ### # # # ##### ### ##### ### # ##################### ### #
# #   # # # #   #           # #   # #         #   # # # # # # # #     # #   #   # # # #     #   #   #     # #         # #         #   # #
# # # # # # ### ######### # ### # ##### ##### # # # # # # # # ### # ##### ### ######### ############# # # # # ##### ### # ####### ### ###
# # # # # #   #         # #   # #     #     # # # # # # # # #   # #   # #   #         # #           # # # # #     #             #   # # #
# # # ### # # # # ### # # # ### # ##### ##### ####### ### # # ### ##### ##### # ### ##### ##### ######### # # # # # ### ### # # # ##### #
# # # #   # # # #   # # # #   # #     #     #     # # # # # # # #           # # # #           #         # # # # # #   #   # # # #     # #
# # ### # # # ### # # ####### ### # ##### ##### ### ### ### ### ### # ##### # ### ### # ##### # ##### ### ### # # ### ### # # # ### # # #
# # # # # # #   # # #       #   # #     #     #         # #       # #     # #       # #     # #     #   # #   # #   #   # # # #   # #   #
# # # ### # # # ### # # # ######### # # ##### # # # ##### ##################### ########### ################# # # # # ##### # # # # #####
# #     # # # #   # # # # #     # # # #     # # # #                       #   #           #           # #   # # # # #     # # # # #     #
# # # # # # # # ####### ### ##### ##### ####### # ##### ### ### # ### # # # ####### ### # ############# # ### # # # # # # # # # ####### #
# # # # # # # #       #               #       # #     #   #   # #   # # #         #   # # # #       # #     # # # # # # # # # #       # #
# # ##### ##### # ##### # # # ##### ############# # ### ##### # # # # ##### # # ##### # ### # ####### # ### # ##### # # # # ### # ##### #
# #     #     # #     # # # #     #             # #   #     # # # # #     # # #     # #           # # #   # #     # # # # #   # #     # #
# # # # # # # # # # # # ####### ######### ####### # # # ### # ########### ### # ################### # # ####### ### # # ### # # # # ### #
# # # # # # # # # # # #       #         #   #   # # # #   # #           #   # #   #   #                       # #   # # # # # # # # #   #
# # # # # # # # ### ### # ####### ### ### # # ### # # # # # # # ################### ### ########### ##### ########### # # ####### #######
# # # # # # # #   #   # #       #   #   # #   # # # # # # # # #                 #                 #     #     #     # #         #       #
### ##### # ### # # ### # ######### # # ### # # ##### ##### # # # ### # ####### # ##### ####### # # # ### # ### ####### # # # # # #######
#       # #   # # # #   #         # # #   # #       #     # # # #   # #       #       #   #   # # # #   # #           # # # # # #       #
### # ##### # # # # # # # # # # # ### ##### # # # ##### ### # # # # # # ### ### ########### ##### ##### # ### # ##### # # ### ### ### ###
#   #     # # # # # # # # # # # #   #     # # # #     #   # # # # # # #   #   #                 #     # #   # #     # # #   #   #   #   #
### # ##### ### # # ### # # # ### # # ### ### # ####### ### # ### # # # # # # # # # ########### ####### ##### ### ##### # # ### # # ### #
#   #     #   # # #   # # # #   # # #   # #   #       #   # #   # # # # # # # # # #           #       #     #   #     # # #   # # #   # #
# ### ### ##### ### # # # ##### # # # ####### ### # ####### # ### # # ##### ####### ##### # ##### ####### ####### # ######### # # # # ###
# #     #     #   # # # #     # # # #       #   # #       # #   # # #     #     #       # #     #   #   #       # #         # # # # #   #
# # # # ### # # # # # # # # # # # # # # ### ### ####### # # # # # # ### # # ##### # ##### # ######### ############# ### ### # # # # # ###
# # # #   # # # # # # # # # # # # # # #   #   #       # # # # # # #   # # #   #   #     # #     #           #     #   #   # # # # # #   #
# ### # ### ### ### # # # # # ### # # # ##### # ### ### ### # # # # # ##### # # # # ##### ### # # ########### ##### ### ### # ### # # ###
# #   #   #   #   # # # # # #   # # # #     # #   #   #   # # # # # #     # # # # #     #   # #                   #   #   # #   # # #   #
# # # # ### # # ### # # # ##### ### # # # # # # # # # # ### # ### # # # ### # # ### ####### # # # ### ### # # ######### # ######### #####
# # # #   # # #   # # # #     #   # # # # # # # # # # #   # #   # # # #   # # # #         # # # #   #   # # #         # #     #   #     #
# # # # ##### # ### # # # # ####### ##### # # ### # # # # ######### # # # # # ##### # ### # # # # ### ### ### # ### ### ##### # ### ### #
# # # #     # #   # # # # #       #     # # #   # # # # #         # # # # # #   #   #   # # # # #   #   #   # #   #   #     #     #   # #
# # # # # ##### # ### # # # ### ### ### # # ### ######### ### # ### # # # # # ### # # ### # # ### # ##### ####### # # # ##### # ### #####
# # # # #     # #   # # # #   #   #   # # #   #         #   # #   # # # # # #   # # #   # # #   # #     #       # # # #     # #   #     #
# ### # ### # # # ##### # # # # ### ####### ##### # ##### # ### # # # ### # # ##### # # # ### # ### # # # ##### # # # # ### # # ##### # #
#   # #   # # # #     # # # # # # #       #     # #     # #   # # # #   # # #   #   # # # # # #   # # # #     # # # # #   # # #     # # #
# ### # # # # # ##### ### ### # # ######### # ### ### # ### ### # ####### ### # ### # # # # ####### # # # # # ######### # ##### ### #####
#   # # # # # #     #   #   # #       #   # #   #   # #   #   # #       #   # # #   # # #       #   # # # # #         # #     #   #     #
# ####### # # # # ### # # # ########### ### ### # # ### ### ### # # ### ### ####### # # ####### ##### ### ### # ######### ### ##### # # #
#     #   # # # #   # # # #               #   # # #   #   #   # # #   #   #     #   # # #     #     # #     # #   #     #   #     # # # #
# # ### # ### # # # # ### # # ####### ### ### # # # # ##### # ### # # # # # ### ####### # ### ########### ### # ### ################# # #
# #   # #   # # # # # #   # #       #   #   # # # # #     # # #   # # # # #   # #           #   #     # #   # #           #         # # #
# # ##### # # # ### # # # # # ####### ### ######### ####### # # # # # ### # # ##### # # ### ##### ##### ####### ##### ### # ### # ### # #
# #     # # # #   # # # # # #       #   #       #         # # # # # #   # # #     # # #   #                   #     #   #     # #   # # #
# # # ##### ### ####### # ### # ####### ########### # ##### # ### ### ##### # # ####### ##### ##### ### # ### # ############# ####### ###
# # #     #   #       # # #   #       #           # #     # #   #   #     # # #   #         #     #   # #   # #             #     # #   #
# # # # # ##### # # # # # # # # ####### # ##### ######### ### ####### # # ### # ### ### # ####### # ### # ##### ######### ### ##### ### #
# # # # #   #   # # # # # # # #       # #     #         #   #     # # # #   # # #   #   #       # #   # #     #         #   #   #     # #
# ### ### # ### ##### # # ### # # # ##### # ##### # ### # ### # # # ### ### # ### # ### ### ### ######### ### # # # ### # ####### #######
#   # # # #   #     # # #   # # # #   #   #     # #   # #   # # #     #   # # # # # # #   #   #       # #   # # # #   # #               #
# # ### # # ### # # ### # ### # # # # # # # # # # ##### ### # # # ### ####### # ##### # ### ### ####### # ### # # ##### ### ### # # #####
# # # #   # #   # #   # #   # # # # # # # # # # #     #   # # # #   #       # #           #   #         #   # # #     #   #   # # #     #
# # # ### # # # # # ### # # ### # # ##### ### ######### # # ### # ### ### ########### # # ### ##### # # # ### ### ### # ### ####### #####
# #   #   # # # # #   # # #   # # #     # # #         # # #   # #   #   #   #         # #   #     # # # #   #   #   # #   #       #     #
# ### # # # ### # # # # # # ### # # # ##### # ##### # ####### ### # # ##### # ##### # # # # # ########### # ### ########### ### #########
#   # # # #   # # # # # # #   # # # #       #     # #       #   # # #     # # #     # # # # #           # #   #         # #   #         #
# # ### # # ### # # ### # # ####### # ######### ### # # ### # ### # # # # ##### # # ### # # # ####### ### # # ##### ##### ##### # ### ###
# #   # # # #   # #   # # #     #   #         #   # # #   # #   # # # # #   #   # # #   # # #     # #   # # #     #           # #   #   #
# # # # # # ### ### ### # # # ##### # ####### ### # # # ### # # # ### # ### # # # # # # # # ####### ####### ### # ####### ### ####### ###
# # # # # #   #   # # # # # #     # #       #   # # # #   # # # #   # #   # # # # # # # # #               #   # #       #   #       #   #
### ### ##### # ### # # # ### ####### ############### # ##### ##### # # # # ### # # # # # # ####### # ### # ##### # ####### ####### # # #
#     #     # #   # #   # # #     # #               # #     #     # # # # #   # # # # # # #       # #   # #     # #       #       # # # #
# # # # # # ### ### # # # # # # ### ### ### ### # ##### # ########### ############# # # # # # # ####### # # # ####### # ##### # # # # ###
# # # # # #   #   # # # #   # #       #   #   # #     # #           #           #   # # # # # #       # # # #       # #     # # # # # # #
# # ### ####### # # # # # ### # # # # # # ##### # # ##### ######################### ### # # # # ### # ##### # # # # # ##### # # ####### #
# #   #       # # # # # #   # # # # # # #     # # #   #             #             # #   # # # #   # #     # # # # # #     # # #         #
# # # # ### ### ### # ### ### # ##### ### ##### ### ### # # # # # ### ### ######### # # # # # # # ### ### ### # # # # ##### ######### # #
# # # #   #   #   # # #     # # #   #   #     #   #   # # # # # #       #         # # # # # # # #   #   #   # # # # #     #         # # #
### # # # ####### ##### # # # # # ####### ### ##### ### # # # ##### ### # # ######### # # ##### ##### # # ### # # ### ### # # ### # # # #
#   # # #       #     # # # # #         #   #     #   # # # #     #   # # #     #     # #   #       # # #   # # #   #   # # #   # # # # #
# # ### # ### # # ##### # # # # # # ##### ### ####### # # # # # ### # # ##### # # ### # ### # # # # # ##### ##### ### # ##### # ### # # #
# #   # #   # # #     # # # # # # #     #   #       # # # # # #   # # #     # # # #   #   # # # # # #     #     #   # #     # #   # # # #
# # ### # # ##### # ### # # # # # # # ### # ##### # # ##### # # ### # # # ### # ####### ##### # # # # ####### # ### ### # # # # # # # # #
# #   # # #     # #   # # # # # # # #   # #     # # #   #   # #   # # # #   # #   #       #   # # # #       # #   #   # # # # # # # # # #
### ### # ### # # # ### # # # ### # # ### # # ### ####### # # ### # # # # ######### # # ##### # # # # ##### ### # ##### # # # # ### # # #
#     # #   # # # #   # # # #   # # #   # # #   #       # # #   # # # # #       #   # #   #   # # # #     #   # #     # # # # #   # # # #
# # # # # ####### # ### ### # ### ### # ##### ############# ### # # ### ### ####### # # # ### ### ### # ####### ####### ### # # ### ### #
# # # # #       # # #     # #   #   # #     #           #     # # #   #   #     #   # # #   #   # #   #       #       #   # # #   # #   #
# # # ### ####### # # # ### # # # ### ### ########### ##### # # # # ####### # ##### # ##### # # # # # # ########### ### ### ########### #
# # #   #       # # # # #   # # #   #   #           #     # # # # #       # #   #   #     # # # # # # #           #   #   #           # #
# # # ### ####### ### # ### # ### # # ### # # ##### ### ### # # # # ### # ### ##### # # ### ##### # ### # # ### ### ### ### # # ### # ###
# # #   #       # # # #   # #   # # #   # # #     #   # #   # # # #   # #   #     # # #   #     # #   # # #   #   #   #   # # #   # #   #
# # # # # # # ### # ### # # # # # ### ##### # ### ### # ### ### # # ### ##### ####### ##### # ### ### # # # # # ### ### ### ### # # # # #
# # # # # # #   #     # # # # # #   #     # #   #   # # #     # # #   #     #     #       # #   #   # # # # # #   #   #   #   # # # # # #
### # ##### # ####### # ### # ### # ### # ### # # ##### # # ##### # # # # ### ####### # ### # ### # # # # # # # ####### ### # ### # #####
#   #   #   #       # #   # #   # #   # #   # # #     # # #     # # # # #   #     #   #   # #   # # # # # # # #       #   # #   # #     #
### ### # # # ##### # # # # # # # # ##### ######### ### ### # ### # ##### ### # ##### # # # ##### # # # ### ### # # # ##### ####### # # #
#     # # # #     # # # # # # # # #     #     # # #   #   # #   # #     #   # #   #   # # #     # # # # # #   # # # #     #   #   # # # #
### # ##### # # ### # # # # ### # # ### # # ### # ####### # # # ### # # # # # # ### # # # ### # # # ### # # ### ##### ##### # # #########
#   #   #   # #   # # # # #   # # #   # # #             # # # #   # # # # # # #   # # # #   # # # # #     #   #     #     # #           #
### # ### # # # ### # # # # ### ### # ### # # ####### ####### ### # # # # ##### ### # # ### # # # # # # # # # # ##### # ####### # ### ###
#   # #   # # #   # # # # #   # #   #   # # #       #     #     # # # # #   #     # # #   # # # # # # # # # # #     # #       # #   #   #
# # # # # # # # ##### ### # # # # # # # # # ### ### # # # ### # # ### ### ### # # # # # ### # # ### # # # # ### ##### ### # # ##### # ###
# # # # # # # #     #   # # # # # # # # # #   #   # # # #   # # #   # # #   # # # # # # #   # # #   # # # # #       #   # # #     # #   #
# # # # # # # # ####### # ### # # # ### ### ### # # # # # ### ### ##### ####### # # # # ### ####### # # # # ### # ##### # # ### ### ### #
# # # # # # # #       # #   # # # #   #   # #   # # # # # #     #             # # # # # #         # # # # #   # #     # # #   #   #   # #
# # # # ### # ########### # # ### # ### ### ### ### ### # # # # # # ####### ######### # ### ### # # # # ### # # # ####### # # ### # ### #
# # # #   # #         # # # # # # #   #   #   #   #   # # # # # # #       #     #     # # #   # # # # #   # # # #     # # # #   # # #   #
# ### # ### # # # # ### # ##### ### # # ### # # # # # ### # # # ### ##### # ####### # # # # ######### # # # ### # # ### ### ##### #######
# #   # #   # # # #     #         # # # #   # # # # #   # # # # #       # #       # # #   #         # # # #   # # #       #     #       #
# # # ##### # ### # # # ####### ### # # ### # # # # ##### ### ##### ### # ######### # # # ### # # # # # # ##### ### ### ### ### ####### #
# # # #     #   # # # #       # #   # #   # # # # #     # #     #     # #         # # # #   # # # # # # #     # # #   #   #   #       # #
### ### # # # # ### ### ### ####### # # # ### ### # # ### ### ##### # ##### # ##### # ### # # # ### # # # # # ### ### # # ### ##### ### #
#     # # # # #   #   #   #     #   # # #   #   # # #   # #     #   #     # #   # # # #   # # #   # # # # # #       # # #   #     #   # #
### # # ### # # # # ############### ### ##### # # # # ##### # ### # ### ####### # ### ### # # # # # # ### ####### ### # ### ####### # ###
#   # # #   # # # #           #   #   #     # # # # #     # # #   #   #       #     #   # # # # # # #   #       # #   #   #       # # # #
# # ##### ### # ####### ### ### ### # ### ### # # # # # # ### ### # ############### # ##### # # ### ##### # ######### # # ##### # # ### #
# # #     #   #       #   #       # #   #   # # # # # # # # # #   #               # #     # # #   #   # # #   #     # # #     # # #   # #
### ##### ### ########### ######### # # ### # # # # # # # # ### # # ########### # # ####### # # # # ### # ### # ##### # ##### ##### ### #
#   #     #             #         # # #   # # # # # # # #   # # # # #         # # #       # # # # # #       # #     # #     #     #   # #
# ### ### # # ##### # ##### ############### # ### ##### ##### # # # # ############# ######### ### ####### ##### ####### ########### # # #
# #   #   # #     # #     #               # #   # #           # # #               #         #   #       #             #           # #  x#
#########################################################################################################################################
