#########################################################################################################################################
#o                        # #                                       # #         #                           # #   # # # #             # #
# ####### # # # ####### ### # ########### # ### ##################### # ######### ################# # ####### # ### # # # ##### ####### #
#       # # # #       #                 # #   #                       #     #                     # #   # # #       # #       #     # # #
# # ##### # # ### # ####### ##### ############# # # ######### ######### ### # ##### ####### ####### ##### # # ####### # ### # ### ### # #
# #     # # #   # #       #     #             # # #         #     #       #       #       # #     #                       # #   #       #
# # # ####### # ######### # ############# ### # # ####### ### ##### ####### ################# ### ##################### ### # # #########
# # #       # #         # #             #   # # #       #   #             #       #             #   #                 #   # # # #     # #
# # ##### ####### # ##### # ##### ### ################################### ##### ### ##### ########### ####### # ######### # ##### ##### #
# #     #       # #     # #     #   #                                   #     # # #     #           # # #   # #         # #             #
# ### ### ########### # ### # # # # # # # # ##################### # ############# # ############# ### # # ####### ### ####### # # # # ###
#   # # #           # #   # # # # # # # # # #                   # #                   #   #     # #             #   #   #   # # # # #   #
# ### # ### # # # ### # ### # ####### ### # # ##### # # ########### ############### # # ### ####### ### # # ### ##### ### ########### ###
#   #     # # # #   # #   # #       #   # #       # # #           #       # #     # #                 # # #   #     #               #   #
# # ### # # # # # ### ### # # # ##### # # # ### # ####### # ### ##### # # # # ##### # ### ################### ############### # # ### # #
# #   # # # # # # # #   # # # #     # # # #   # #       # #   #     # # #         # #   #                   #               # # #   # # #
# ### # ### ##### # ##### # ### # # # # # ####### ##### ##### # # ### ### # # ##### # # # ### # ### ####### ### # ####### # # ####### ###
#   # #   #     #       # #   # # # # # #       #     #     # # #   #   # # #     # # # #   # #   #       #   # #     # # # #       #   #
# # ### # ##### ####### # # # # ##### # # ######### # # # # ##### ### # ### # ### # # # # # ### # ### # # ### ### # ### ####### #########
# #   # #     #       # # # # #     # # #         # # # # #     #   # #   # #   # # # # # #   # #   # # #   #   # #           #         #
# # # # ##### # # # # # # # # # ####### # ##### # ### # # # # # # ######### # ######### # ### # ######### # # # # # ### # ### ####### ###
# # # #     # # # # # # # # # #     #   #     # #   # # # # # # #         # #       #   #   # # #       # # # # # #   # # # #   # # #   #
### ### ##### ### ##### ##### # # # ### # # # # # ### # # ### ##### ####### ### # ##### # # ##### ### # # # ##### # ### ### ##### # #####
#   #       #   #     #     # # # #   # # # # # #   # # #   #     #     # #   # #     # # #         # # # # #   # #   #                 #
### ### # ### # # ####### ############# # # # # ############# ########### # ####### # # ### ### ######### ### ### ### ###################
#     # #   # # #       #             # # # # #       # #   #             #       # # # #     #         #   #   #   #                   #
### # ### # ##### ##### ################### # # ####### # ##### ############# ##### # # ### # # # ########### ####### # ### # ##### #####
#   # #   # #   #     #                   # # #     #         #             #     # # #   # # # #       #         # # #   # #   # # #   #
# # # # # # ### ### ### # ### # # ### # # # # # # ### ##### # # # ### # ### ######### # # # ### # # ##### ######### ### # ### ### ### ###
# # # # # #       #   # #   # # #   # # # # # # #         # # # #   # #   #         # # # #   # # #                 # # # # #           #
# # # # # # # # # # # ####### # # ### ### # ### ########### ####### ### ### # ######### ####### # # ################# ### # ### # # ### #
# # # # # # # # # # # # #   # # #   #   # # #             #       # # #   # #   # # # #       # # #                     #     # # #   # #
# # ### ### # # # # ### # ### ### ##### # # ### # # ######### # ##### ########### # # ############# # # ### # ### # # # ####### ### #####
# #   #   # # # # #         #   #     # # # #   # #         # #               #                   # # #   # #   # # # #   # # # # #     #
# # ### # ### # ####### # ### # # ### # ####### # # # # # ############### # ### ######### ######### # # ### # ### ### # ### # ### # #####
# #   # #   # #       # #   # # #   # #     #   # # # # #               # #             #         # # #   # #   #   # #           #     #
# # # ### ##### ### ### # # ##### ### ### # ### # # # ########### ### ############# # ### ### # # ### # # # # ### # # # # ##### ### #####
# # #   # #       #   # # #     #   #   # #   # # # #           #   #             # #   #   # # #   # # # # #   # # # # #     #   #     #
# # # ### ##### # ### # # ########### ####### # # # # # ### # # # ##### # ##### ### # # # # # ### ##### # # # ### # # # # # # # ### # ###
# # # #       # #   # # #           # #     # # # # # #   # # # #     # #     #   # # # # # #   #     # # # # # # # # # # # # # # # #   #
# # # # # # # # # # ##### ### ### # ### ####### # ##### # ### ### ##### # ####### # # ### ### # ### # ### # # # ##### # # # # ### # # ###
# # # # # # # # # #     #   #   # #           # #     # #   #   #     # #       # # #   #   # #   # #   # # #       # # # # #     # #   #
# # # ### # ### # ### # # ### # # ####### # ####### ### ### # # ### ### # ### # # ####### # # # # # # # ### # ### # # ##### ##### # # # #
# # #   # # #   #   # # #   # # #       # #       # #     # # #   #   # #   # # # # #   # # # # # # # #   # #   # # #     #     # # # # #
# # # # ### ### # ### # # # ##### ########### ### # ### # # # # # # ### # ### ##### # ### # ### # # # ##### ######### ##### # # # ### ###
# # # # #     # #   # # # #     #           #   # # #   # # # # # #   # #   #   #       # #   # # # #     #     # # #   # # # # #   #   #
# # # # # # ### # # # # ### ### # # # ### ##### # # # # # # ### # # ##### ### ### ### ######### ### ##### # # # # # ##### ### # #########
# # # # # #   # # # # #   #   # # # #   #     # # # # # # #   # # #     #   #       #       # #   # # # # # # #   #         # #         #
# # # ### # # # # # # ### # ######### # # ### ####### # # # # # # # ##### # ##### ########### ### ### # ########### ### ### # # # #######
# # #   # # # # # # #   # #       #   # #   #       # # # # # # # #     # #     #             # # # #                 #   # # # #       #
### # # # # # # # ######### ##### ### # # # # ######### # # ####### # ##### # ### ############# ### # ####### ####### ##### # ### ### # #
#   # # # # # # #         #     # # # # # # #         # # #       # #     # #   #             #             #       #     # #   #   # # #
### # # # # ############### ### ### ##### # ##### # ### ### ##### # # ### # # # # ### # ####### ############### ############### ### ### #
#   # # # #               #   #         # #     # #   #   #     # # #   # # # # #   # #                       #               #   #   # #
# # ### # # ##### # ### # # ####### ### # # # # # # # # ##### # ### # # # ### ##### ##### # ############# # # ########### ### ##### # # #
# #   # # #     # #   # # #   #   #   # # # # # # # # #     # #   # # # # #       #     # #             # # #           #   #     # # # #
### ### # # # # # # # # # # # # ######### ##### ### ### ######### ### ##### # # ##### # ##### # # # ##### # # # ################### ### #
#   #   # # # # # # # # # # #           #     #   #   #         #   #     # # #     # #     # # # #     # # # #                   # #   #
# # ### ### ### # ### ### # # ####### ##### ##### ##### # # # # # # # ######### # # ### # ##### # # # # # ### # # # ##### ####### ### # #
# #   # #     # #   #   # # #       #     #     #     # # # # # # # #         # # #   # #     # # # # # #   # # # #     #       #   # # #
# # # ### # # # # # ### # # # ### # ##### # ##### ### # # ### # ##### ######### ### # ######### # ####### # ####### ### # ############# #
# # # #   # # # # #   # # # #   # #     # #     #   # # #   # #     #       #     # #         # #       # #       #   # #             # #
# ### ### # # ### ### ##### # # ### # # ############# # ####### # # # # # # ### ### # ### # ##### # ### # ####### # ### # ##### # # # # #
#   # #   # #   #   #     # # #   # # #             # #       # # # # # # # # #   # #   # #   #   #   # #       # #   # #   # # # # # # #
# ####### # ##### ######### # # # # # # # ##### ##### ##### ### ##### # # ### # ### # ### ### # # # # # ######### # ##### ### ##### ### #
#     #   #     #         # # # # # # # #     #     #     #   #   #   # #     #   # #   #   # # # # # #       # # #     #         #   # #
# # ####### ##### # ##### # # # # ### # ### # ### ##################### # # ### # # # ### # ##### # # # ### ### ##### ### # # # ##### # #
# #     #     #   #     # # # # #   # #   # # # #                   #   # #   # # # #   # #     # # # #   #         #   # # # #     # # #
# # ### ### # ### # # ##### # ### ### ### # ### ### ########### # ### # # # # # ### # ##### # # # ### # ### # # # ### ### # # # #########
# #   # #   # #   # #     # #   #   #   # #       #           # #   # # # # # #   # #     # # # #   # #   # # # #   #   # # # #         #
# # # ### # # ### # # # ### ### # ### # # ### ### ##### # # # ### ##### ### ### ### # # # # # # # # # # ### # ### # ##### ### # #########
# # # #   # #   # # # #   #   # # #   # #   #   #     # # # #   #     #   #   #   # # # # # # # # # # #   # #   # #     #   # #         #
# # ####### ##### # # ### # # ### # # # # ### # # ### # # # ####### # ### ##### ##### # ### ##### ##### ### # # ######### # ### # # # # #
# #   #         # # #   # # #   # # # # #   # # #   # # # #       # #   #     #     # # #       #     #   # # #         # #   # # # # # #
# ####### # # # # # # # # # ##### ### # # ### ### # ##### ### # ### # # # # ######### # ### # ####### ##### ######### ### # # ### # ### #
#       # # # # # # # # # #     # #   # #   #   # #     #   # #   # # # # #         # #   # #       #     #         #   # # # # # #   # #
# ### ### # # # ### # ### # # # # # # # # # ############# # ####### # # # # ### # ########### ### # # # ##### # ### ##### # ### # #######
#   # # # # # #   # #   # # # # # # # # # #             # # #     # # # # #   # #           #   # # # #     # #   #   # # #     #       #
# # # # ### # # # # # ##### ####### # # # ### ##### ######### ########### # ############### # ### ### ### ### # # # # # ##### ##### # ###
# # #   #   # # # # #     #       # # # #   #     #                     # #               # #   #   #   #   # # # # #       # #   # #   #
# ### ### ### # # ### # # # ####### ##### # # # # # ### # # ##### # ##### # # # ### ##### # # # # ### # # # ### # ### ######### ### #####
#   #   # #   # #   # # # #       #   #   # # # # #   # # #     # #     # # # #   #     # # # # #   # # # #   # #   #             #     #
# ### ##### # # ##### ### # # ##### # # # # # # ### ### # ##### # # ####### ##### # ### ### # # # # # ##### ### # ### # # # # # ### #####
#   #   #   # #     #   # # #     # # # # # # #   #   # #     # # #       #     # #   #   # # # # # #     #   # #   # # # # # #   #     #
# ### ##### # # # ### ### # # # # # ### # # # # # # ### # # # # # # # # ### ####### # # ### # # # # ##### # ##### # ### # ####### ### ###
#   #     # # # #   #   # # # # # # #   # # # # # #   # # # # # # # # # # #       # # #   # # # # #     # #     # #   # #       #   # # #
# # # # ##### # # ### ### ### # # ### # # # ### # # # ### # ### # # # # # # ##### # # # ### # ##### # ##### ##### # # # # # # ### ##### #
# # # #   #   # #   # #     # # #   # # # #   # # # #   # #   # # # # #   #     # # # #   # #   #   #     #     # # # # # # #   #     # #
# ### ### # # # # ##### # ### # # ##### # # # ### # # # ####### # ### # # # # ########### ### ##### # # ### ### ### # ### # # # # ### # #
#   #   # # # # #     # #   # # #   #   # # #   # # # #       # #   # # # # #           #   #     # # #   #   #   # #   # # # # #   #   #
# # # ####### # # # ### # ### ### ##### # # # ##### ####### ### # ##### # # ####### ##### ### # ### # ### ### # ##### ##### ### # ##### #
# # #       # # # #   # #   #   #     # # # #     # #   # #   # #     # # #       #     #   # #   # #   #   # #     #     #   # #     # #
# # # # # ##### # # ##### # # ### ### # # # ### # # # ### ### # ### # # # # # # ####### # ####### # # # # # # # ### ####### # # # # #####
# # # # #     # # # #   # # #   #   # # # #   # # #         # #   # # # # # # #       # # #     # # # # # # # #   #       # # # # #     #
# ##### # ### # ### ### ### ### # # # # # # # ##### ### ### ##### # # # ### # # ############# ### # ##### # ### # ### ### # # # # # # # #
#   #   #   # # #     #   #   # # # # # # # #   #     #   #     # # # # #   # # #               # #     # #   # # # # # # # # # # # # # #
# # ### ##### ##### ### ### # ### ####### # ##### # # # # # # # ### # ##### # ### ### ####### # # ### ### # # # ### ### ##### # # # # # #
# # #       #   #         # #   #     #   #     # # # # # # # #   # #   #   #       #       # # #   #   # # # #             # # # # # # #
### ### # # # # ### # ### ### # # # ####### # ### # # # # ### # ### # ##### # # ### # ########### # ### # # # # # # ### # # # ### ### ###
#   #   # # # # #   #   #   # # # #     #   #   # # # # # #   #   # #     # # #   # #           # #   # # # # # # #   # # # #   # #     #
# # # # # # # ### # ### ####### # ### # # # # ### # ### # ### # # # # ### ### # ### # ##### ### ######### # ### # # # # # # ####### # # #
# # # # # # #   # #   #       # #   # # # # #   # # # # #   # # # # #   # #   #   # #     #   #         # # #   # # # # # #       # # # #
### ### ### # ### # ### # ### # # # # ### ### # # # # ######### ##### # ##### # # ### ##### ##### # ######### # ### ##### # # ####### ###
#   #     # # #   #   # #   # # # # #   #   # # # #           #     # #     # # #   #     #     # #         # #   #     # # #   # #     #
# # ### # # # # # # ### # ##### # # # # ### ####### ####### # # # ### ### ### # # # # # # ##### ####### # ##### # # # ########### #######
# #   # # # # # # #   # #     # # # # #   # #             # # # #   #   #   # # # # # # #     #       # #     # # # #                   #
### # # # ####### # # # # ### # # ### ########### # # ### ####### # ##### ### ####### # ####### # ####### # ### ##### ######### #########
#   # # #       # # # # #   # # #   #         #   # #   #   #   # #     #   #     #   #       # #       # #   #     #     #   #     #   #
# # ### # # ### ### # # # ### ### # # # ####### ### # ####### ######### # ### # # # # # # # ### ########### ### ##### # ### ######### ###
# # #   # #   #   # # # #   #   # # # #     #   #   #           #     # #   # # # # # # # #   #           #   #   #   #                 #
##### # ### # ####### # # ### ####### # # # ### # # ### # # # ### ##### # ### # # # # # # # ### ### ####### # # # ### ### # # ######### #
#     #   # #     #   # #   #       # # # #   # # #   # # # #         # #   # # # # # # # #   #   #       # # # #   #   # # #         # #
### # # # # # ##### # # # ### # ##### # ######### # # # # # # # ##### # ##### # # # # # # # ### ### # ##### # # # # # # # ### ### # #####
#   # # # # #     # # # #   # #     # #       #   # # # # # # #     # #     # # # # # # # # #     # #     # # # # # # # #   #   # #     #
### # # # # # # # # # # # # # ####### # # ##### # ### # # ### # # ### # # # ######### # # # ### # # # # ### # ### ####### # ##### # #####
#   # # # # # # # # # # # # #     # # # #     # # #   # #   # # #   # # # #         # # # #   # # # # #   # #   #       # #     # #     #
# # # ### # ### ##### # ### # # # # ### ### ### # # # ######### # ### # # # # # ##### # # # # # # ##### # ### ### # # # ### # ### # # # #
# # #   # # #       # #   # # # #     #   #   # # # #         # #   # # # # # # #   # # # # # # #     # #   #   # # # #   # #   # # # # #
# # # # # # ### # ##### # # # # # # # # # # # ### # # # ### ##### # # # # # ### # ##### ### # # # # ### ### # ####### ##### # # ##### # #
# # # # # # #   #   #   # # # # # # # # # # #   # # # #   #   #   # # # # #   #       #   # # # # # # #   # #       #     # # #     # # #
# # # # # # # ### # ### ##### # # ### # ########### # # # # ##### ##### # # ### # ### # # ##### # ### ####### # ### # # # # # # #########
# # # # # # # #   #   #   #   # #   # #           # # # # #     #     # # #   # #   # # #     # #           # #   # # # # # # #         #
# # # # ### # # # ##### # # # ####### # # # ####### # # ### # # # # ### # # # # ######### ### # ##### # # ### # # ### # # ##### # # # ###
# # # #   # # # #   #   # # #       # # # #       # # #   # # # # #   # # # # #         #   # #     # # #   # # #   # # #   #   # # #   #
# ### # # ### ### ##### ##### ######### # # ########### ### # ### ##### ### ### ### # ### ### # # # ############# # ### # ##### # # # # #
#   # # #   # #     #     #           # # #           #   # #   #     # # #   #   # #   #   # # # #             # #   # #     # # # # # #
# # # ### ### # # # # # # # # # # ### ### # # ### ### # # ### # # # ### # # ######### ### ### ### # # # ### ############# # # # # # # ###
# # # #   #   # # # # # # # # # #   #   # # #   #   # # #   # # # #   # #           #   #   #   # # # #   #           # # # # # # # #   #
# ### ### ### # # # ### # ### # # # # ### # # ### # # # # ##### ### ### ### ######### # ### # ##### # ####### # ####### # # #############
#   # #     # # # #   # # #   # # # #   # # #   # # # # #     #   #   # #           # #   # #     # #       # #   #   #   #       #     #
# # # # # # # # # # ### # # # # # # # ### ### ### ##### # # ####### ### ### # # ##### ##### # # ######### ####### # ############### ### #
# # # # # # # # # #   # # # # # # # #   #   #   #     # # #       #   # #   # #     #     # # #         # # #   #   #   # #           # #
# # # # # ####### # # # ### # # ### # ### ##### # # ############### ##### # # ##### ######### # ####### ### # ### ### ### # ### #########
# # # # #     #   # # #   # # #   # #   #     # # #           #   #     # # #     #     # # # # #   # # # # # # # #   # # #   #   #     #
# ### # # ### ### ### # # # # # ### # # ##### ####### ######### ##### ### # # ##### ##### # ##### ### ### # # # ### ### # # ####### #####
#   # # #   #   #   # # # # # # #   # #     #       #               #   # # #     #                                                    x#
#########################################################################################################################################
