#########################################################################################################################################
#o    # #   # # # # #             # #   # #     #       # #   #                         # #               #     #                       #
# ##### # ### # # # # ############# # ### # ##### ##### # # ### ################# ####### # ##### ######### ### # ################### ###
#               # #                                   # #       #   #           #       #   # # #     # #     # #       #           #   #
# ##### # # # ### # ### ### ##### ##### # # # ### ######### ### # ### ######### # # # ### ### # ####### # ####### ####### ####### ### ###
#     # # # # #       #   #     #     # # # #   #             #           #   # # # #             # #       # #                 #   # # #
# # # ### ##### ### # # # # # # # ### # # ####### ### ############# ##### # ################### # # # ####### # ### # ################# #
# # #   #         # # # # # # # #   # # #       #   #             #     #           #         # #                 # #             # #   #
# # ####### ### ### # ##### ### ### # # # ##### ##### ### # ####### ### ##### # ##### ############# # ##### ##### # ############### # ###
# #       #   #   # #     #   #   # # # #     #     #   # #       #   #     # #   #               # #     #     # #                     #
# # # # # ######### ### ##### # # ### # ##### # # ### ################# ### ####### ### ######### ### ### ##### ### ### ######### # ### #
# # # # #         #   #     # # #   # #     # # #   #     #           #   #   #       #         #   #   #     # # #   #         # #   # #
# # # # ########### ####### # ### # ### # ####### ##### ### ### # ##### ####### ############### # # # ### # # ### ##### #################
# # # #           #       # #   # #   # #       #     #       # #     #                       # # # #   # # #         #         #   # # #
# ### # # # ##### # # # # ### # ######### ##### # ####### ### ### # # # ######### # # # ### # # # # # # ##### # ######### # ##### ### # #
# #   # # #     # # # # #   # #         #     # #       #   #   # # # #         # # # #   # # # # # # #     # #         # #   #     #   #
##### # # ### ##### # # ######### ########### # # ######### ############### ########### # # # ####### # ### # # # ####### # ### ##### ###
#     # #   #     # # #         #           # # #         #           # # #           # # # #       # #   # # # #       # #             #
### # ####### # ### # ### ### # # # ### # # # # # ### ####### ######### # ####### ##### ######### # # # # ### ### ########### # ### ### #
#   #       # #   # #   #   # # # #   # # # # # #   #       #   #   # #         #     #         # # # # #   # #             # #   #   # #
# ### # ##### ### ### ### # ### # ####### # # # # # # # # # ##### ### # ##### ### ######### ##### # ####### # ### # ########### # #######
# #   #     #   #   #   # #   # #       # # # # # # # # # #                 #   #         #     # #       # # #   #           # #     # #
# ### # ### # ########### # # ### ### # # ### # ### ########### # ### ### # # ### ####### # ##### ### ### # # ### # # ### ##### ##### # #
#   # #   # #           # # # # #   # # # #   #   #           # #   #   # # #   #       # #     #   #   # # #   # # #   #     #     #   #
# ##### ######### # # # # ##### ####### ##### ##### # # ####### ##### ### ### ### # ##### # ####### ### # # # ### # ######### # ####### #
#     #         # # # # #             #   # #     # # #       #     #   #   #   # #     # #       #   # # # # # # # #       # #       # #
# ##### ##### ##### # ##### ### ### ####### ####### # # # # # # ##### # ### ##### ####### # ######### # ####### ##### ######### ### # # #
#   #       #     # #     #   #   #             #   # # # # # #     # #   #     #       # #         # #   #   #               #   # # # #
# # # # # # ##### ### # ##### ### # # ##### # ### # # # # ##### # # ### ####### # # ### ##### ############# ### ##### # ######### ### ###
# # # # # #     #   # #     #   # # #     # #   # # # # #     # # #   #       # # #   #     #       #               # # #       #   # # #
# ### # # # # ####### # # # ##### ##### # ### ### ### # ### ### # ######### ##### # # ############### ##### ############# ############# #
#   # # # # #       # # # #     #     # #   #   # #   #   #   # # #       #     # # #           #   #     #       #           #         #
# ### # # ### # ### # # # ##### # # ####### ### ##### # ### ### # # ######### # ################# ### ####### # ### ##### # ### ##### # #
#   # # #   # #   # # # #     # # #       #   #   #   #   #   # #           # #     #           #         # # #         # #         # # #
# ### # # # ##### ##### # # # ##### ### ########### # ### # # ### ### # ### ######### ##### ##### ### ### # ############# ### # # #######
#   # # # #     #     # # # #     #   #           # #   # # #   #   # #   #               #         #   #               #   # # #       #
# ### # # ### # # # # # # # # # ##### # ##### ### # # ### ####### # # ### ########### ########### ### ### # ####### # ####### ######### #
#   # # #   # # # # # # # # # #     # #     #   # # # # #       # # #   #           #           #   #   # #       # #       #         # #
# ##### # # ####### ##### ### ##### ######### ####### # ### # # # # ### ######### # # # ### ### # # # ### ####### ######### # # # ### # #
#   # # # #       #     # #       #         #       #     # # # # #   #         # # # #   #   # # # #   #       #         # # # #   # # #
# # # ### # ### ### # ### # # ### # # # # # ######### # # # # # # # # # ### ##### ### # # # ####### ### # # # # ##### ##### ####### ### #
# #   #   #   #   # #   # # #   # # # # # #         # # # # # # # # # #   #     #   # # # #       #   # # # # #     #     #       # #   #
# ####### ### ### ### # # ### # ### # # # ### ### ### ### ### # # # # ### # # # ### # # ##### ####### # # # # # ####### ##### ##### ### #
#       #   #   #   # # #   # #   # # # #   #   #   #   #   # # # # #   # # # #   # # #     #       # # # # # #       #     #     #   # #
# # # # # ### # ##### # # ####### ##### # # ### ### ##### # # # # # # # ### ######### ### # ### # # ##### ### # # # # # # # # ##### # # #
# # # # #   # #     # # #       #     # # #   #   #     # # # # # # # #   #       #     # #   # # #     #   # # # # # # # # #     # # # #
# ####### # ### # # # # # ############# # ##### ##### ### ### ####### # # # # # # # # # # ### # # # # ### ######### ### ### # ### ### # #
#       # #   # # # # # #             # #     #     #   #   #     #   # # # # # # # # # #   # # # # #   #         #   #   # #   #   # # #
# # ### # ##### # ### ### ### # ##### ### ### ##### ##### # # # ### # ### # ##### ### # # # # ### # # ### ### # ### # # ######### ### ###
# #   # #     # #   # #     # #     #   #   #     # #   # # # #   # #   # #     #   # # # # # #   # #   #   # #   # # #         #   #   #
# # ##### # ### # ##### # # # # # # ##### # # ### # # ### ########### ##### # ##### # ### ### ### ### ### ### # # # # # ### ### ##### ###
# #     # #   # #     # # # # # # #     # # #   # #     #         # #   #   #     # #   #   #   #   #   #   # # # # # #   #   #     #   #
### # # ### # ########### ### # # ### ### # # # # # # ### # # ##### # ##### ### ####### ### ### # ### # # ### # ######### # # ### #######
#   # #   # #           #   # # #   #   # # # # # # #   # # #       #     #   #       #   #   # #   # # #   # #         # # #   #       #
### # ##### # # ##### # # ### # # # # # # # # # # # ### ### # # # # # ##### # ##### ### ### ##### ##### # # # # ####### # # #############
#   #     # # #     # # #   # # # # # # # # # # # #   #   # # # # # #     # #     #   #   #   # #     # # # # #       # # #             #
# # # # # # ### ### # # # # ####### # ##### # # # # ##### ### # # # # # # # ################### # ##### ####### # ### # ##### # #########
# # # # # #   #   # # # # #       # #     # # # # #     #   # # # # # # # #   #       # # #     #     #   #   # #   # #     # #         #
##### # # # # # ### # ### ########### # ### ### ### # # # # ### # # ### ### # # ####### # # ############### ### # ############### # ### #
#     # # # # #   # # #           #   #   #   #   # # # # #   # # #   #   # #       #         #           #   # #               # #   # #
##### # # ### # ##### ### # # ##### # # ### ### # # # ### # ############# ### # ##### ##### # # ########### ### ##### ######### ### #####
#     # #   # #     #   # # #     # # #   #   # # # #   # #             #   # #           # #         # #     #     #         #   #     #
### # # # ### # # ### ### ### ####### # # # ### # ##### # # ##### # # ### ### # ### ##### ############# # ####### ### # # # # # ####### #
#   # # #   # # #   #   #   #   #   # # # #   # #     # # #     # # #   #   # #   #     #     #                 #   # # # # # #       # #
# # # # # # # # ####### # ####### ### # ### ### ##### # ### ##### # ##### ##### # ### # ####### ########### # # ### ### ### ##### # #####
# # # # # # # #       # #           # #   #   #     # #   #     # #     #     # #   # #   # #     # # #   # # #   #   #   #     # #     #
### # # # # # # # ##### # # ### # ### # ### # # # ### # # # # # # # # # # # ### # # # # ### # ### # # # ######### # ####### # ### ### ###
#   # # # # # # #     # # #   # #   # # # # # # #   # # # # # # # # # # # #   # # # # #         #               # #       # #   #   #   #
### # # ### # # # ### ### # ##### ####### # # # # # ### ### # # # # ### # # ##### # # # ##### ##### # ### # ### ########### # # # # # # #
#   # #   # # # #   #   # #     #         # # # # #   # #   # # # #   # # #     # # # #     #     # #   # #   #   #       # # # # # # # #
# ### ### # # # ### # # # # ##### # ### # ##### ##### # ### # # # ### ##### # # # ### # # # ##### # # # ### # ##### ######### ### ### ###
# #     # # # #   # # # # #     # #   # #     #     # #   # # # #   # #   # # # #   # # # #     # # # #   # #               #   #   #   #
# # # ####### ### ### # # # ##### # ##### ### # ##### # ### ### # ####### # # # ### ### ### # ### # ##### ### ##### # ### ############# #
# # #     #     #   # # # #     # #     #   # #     # #   # # # #       #   # #   # #     # # # # #     #   #     # #   #           # # #
# ### ### # # ### ### # # # ##### ##### # # ### ##### # # # # ### # # ### # ### # # # # ### # # # ### # # # # # # ######### ### # ### ###
# #     # # #   #   # # # #     #     # # #   #     # # # #     # # #   # #   # # # # #   # #   #   # # # # # # #         #   # #       #
# # # ####### # # # # ### # ##### ### ####### # ##### # ### ##### ##### # # # # # ##### ### # ### ### # ### ##### ##### ### ### # #######
# # #       # # # # # #   #     #   #       # #     # # #       #     # # # # # #   # #   # # # #   # #   # #   # # # #   #   # #       #
# # # # # # # # # # # ### # # ### ########### # ##### # ### # ### # ### # # # ####### # ##### # # ####### # # ##### # ########### # # ###
# # # # # # # # # # #   # # #   #           # #     # # #   #   # #   # # # #   #     #     #   #       # #             # #     # # #   #
# # # # # ### ### ### ### # # # ########### ### ### # # # # # ### ### ##### ### # ##### # ### ### # # ### ##### # ####### # ####### #####
# # # # # #     #   #   # # # #           # # #   # # # # # #   #   #   #     #       # #   #   # # #   #     # #                 #     #
# # # # ### # # ### ### # # ### ############# ### ##### ### # ##### ####### ### # # ### # ### # ### # ### # # # ### ### ### # # ### # ###
# # # # #   # #   #   # # #   #               # #   #     # #     #     #     # # #   # #   # #   # #   # # # #   #   #   # # # # # # # #
# # # # # # # # ### ##### ### # # ### ######### ##### # ##### # # # # ### # # # # ### # # ### # ### # # # # # # ########### ##### ##### #
# # # # # # # #   #     #   # # #   #               # #     # # # # #   # # # # #   # # #   # #   # # # # # # # #         #     # #     #
# # ####### # # # # ##### ### # ##### ### ### # ##### # # # # ##### # # # # ### # # ### # # # ####### # # # # ### ### ##### ##### # ### #
# #     #   # # # #   #     # #     #   #   # #     # # # # #     # # # # #   # # #   # # # #       # # # # #       # # # # #         # #
# # # ### # # # # # ##### ####### ### ##### # ####### # # # # ### ### ### # ### ### # # # # ### # # # # # # # ##### ### # ### ##### # # #
# # #   # # # # # #     #       #   #     # # #     # # # # #   #   #   # #   #   # # # # #   # # # # # # # #     #     #         # # # #
### # ##### # ### # # ### # ### # # ########### ### ### ### # ####### # ### # # ### ##### # ##### ### # # # # # ### # # # ### # ### #####
#   #   #   #   # # #   # #   # # # # #           #   #   # #       # #   # # # #       # #     #   # # # # # #   # # #     # #   #     #
### # ##### # ##### # # # # ##### ### # ##### ### ######### ### ### # # ##### # ### # # # ### # # ##### ### ####### ### ######### # # # #
#   #   #   #     # # # # #   #             #   #         # # #   # # #     # # #   # # #   # # # #   # # #     #     #         # # # # #
##### ##### # # ### # # # # # # # # # # # ### ### ########### ### ### # ### # # ### ### # ### ##### ##### # ####### # # # ############# #
#         # # # #   # # # # # # # # # # #   #   #               #   # #   # # #   #   # # #               #       # # # #             # #
# # # ##### # # # # # # ### # # # # ### # # ### ### # # # ### ### ##### ### # ##### # # # ### ### ### ##### # # # # # ### # # ### # ### #
# # #   # # # # # # # #   # # # # #   # # #   #   # # # #   #   #     #   # #     # # # #   #   #   #     # # # # # #   # # #   # #   # #
# ### # # ### # ### ### # # ### # ##### # ### # # ### # # # # # # ############# # # # ### ##### # ### # ### ### ##### ####### # # # ### #
# #   #     # # #     # # # #   #     # #   # # #   # # # # # # #             # # # # #       # #   # #   #   #   #         # # # # #   #
# # # ### # # ### # # # # ### # # # # # # ### # # ### ##### ##### # # # ### ####### ### # # # # # ### ############# # # # ####### # ### #
# # #   # # # #   # # # #   # # # # # # #   # # # #       #     # # # #   #     # #   # # # # # #   #             # # # # # #   # #   # #
##### # ### # # # # # # # ### # # # # # # # # # # # # ### # # # # ### ### # # # # ####### # ##### ### ############### # # # # ### # ### #
#     #   # # # # # # # #   # # # # # # # # # # # # #   # # # # #   #   # # # #         # #     #   #               # # #       # #   # #
# # # # ##### ### # # # # # ### ### # # ### # ### ### ### # ##### # ##### # ######### ### # # ########### # ####### # # # # # # # # # ###
# # # #     #   # # # # # #   #   # # #   # #   # #     # #     # #     # #         #   # # #           # #       # # # # # # # # # # # #
### # # ####### # # # # # ##### # # # ####### # # # # # # ####### # ##### # # # # # ### # ### # ### ##### # ### # # # ####### # ####### #
#   # #       # # # # # #     # # # #       # # # # # # #     #   #     # # # # # #   # # #   #   #     # #   # # # #       # #         #
# # ### # # # ### # # # # # ### ####### # ### # # ### # ######### # ### ### ### ##### # # # # # # # # # ### # # ##### # # ### # #########
# #   # # # # #   # # # # #   #       # #   # # # #   #         # #   #   #   #     # # # # # # # # # #   # # #     # # #   # #         #
### ##### ### # # # # # # # ### # ### # # # ### # # # # ####### # ######### # # # # ######### # # ### ### # ######### # # # ### #########
#       #   # # # # # # # # #   #   # # # #   # # # # #       # #         # # # # #       # # # #   #   # #         # # # # #           #
### ### # # ### # # ### ##### # # # # # # # ### ### # # # ##### # # # ####### ### # ####### # # # ### ### ############### # # # # # # ###
#     # # #   # # #   #     # # # # # # # #   #   # # # #     # # # #       #   # #         # # # # #   #     #         # # # # # # #   #
# # # # ### ### # # ### ### ### # ##### # # ### ##### # # ##### # ### # ########### # ### # ### # # ### # ##### ########### ### # ### # #
# # # #   #   # # #   #   # #   #     # # #   #     # # #     # #   # #         #   #   # #   # #     # #   #             #   # #   # # #
### ##### ######### ### # # # # # ##### ######### # # # # ##### # ### # # # ### # # # # # # ### # # # ### # # ### ############# # # # # #
#       #       #     # # # # # #     #         # # # # #     # #   # # # #   # # # # # # #   # # # #   # #     #             # # # # # #
# # # # ####### ### # # # ##### ############### # # # # ### ##### # # # # ##### ### # # # # ##### ### ### # ### # ######### # # ##### # #
# # # #       # #   # # #     #               # # # # #   #     # # # # #     #   # # # # #     #   #   # #   # #         # # #     # # #
# # # # # ####### # ### # ##### # # # # ### # # # ### # # # # ### ### # # ##### # # # # ### ### # # # # # # # # # ### # ##### ##### # # #
# # # # #       # # #   #     # # # # #   # # # # #   # # # #   #   # # #     # # # # # #     # # # # # # # # # #   # #     #     # # # #
# ### # # # # # # # ### # ### # # ####### # # # # ### # ### # # # ##### # # ### # # # ##### # # # # # # # # # ### # # # # ### # ### # # #
# #   # # # # # # # #   #   # # #       # # # # #   # #   # # # #   #   # #   # # # #     # # # # # # # # # #   # # # # #   # #   # # # #
# # # ### ### # ### ### ### ### # ### # ####### ##### ##### # # # # # # # ### ### # # # # # # # # ##### # # ### # # # # # ############# #
# # #   #   # #   # #     #   # #   # #       #     #     # # # # # # # #   # #   # # # # # # # #     # # #   # # # # # # #           # #
### # # ### # # ### ### ######### # # # ### ####### # # ####### ##### ##### ##### ##### ##### # ### ####### # ### # ### ### ####### #####
#   # #   # # #   # #           # # # #   #       # # #       #   #       #   #       #     # #   #       # #   # #   #           #     #
### # # # # ### # ##### # # # # # # # # ### ##### ### ####### # # # # # # # # ### # # # # # # # # # ##### ### # # # # # ##### ### # # # #
#   # # # # #   #   #   # # # # # # # #   #     # #         # # # # # # # # # #   # # # # # # # # #     #   # # # # # #     #   # # # # #
### # # # # ### # ##### ##### ### ### # # # ### ##### # ########### # # # ### ### ### ### # ### # # ### # # # ####### ####### # #########
#   # # # # # # # #         # #     # # # #   #     # #           # # # #   # #     #   # #   # # #   # # # #       #       # #         #
### # # # ### ### ### # # # ##### # # # ### ##### # ### ### ####### ### # ####### ### ### # # # ### # ####### # # # # # # # # # # ### ###
#   # # # #     #   # # # #     # # # # #       # #   #   #   #   # # # #       #   # # # # # #   # #     # # # # # # # # # # # #   #   #
### ##### # ######### # # ####### # # ##### # ### ############# ##### ##### # ### ##### ##### # ### # # # # ##### # ######### # ### #####
#       #           # # #     #   # #     # #   #                         # # #           #   #   # # # #       # #         # #   #    x#
#########################################################################################################################################
