#########################################################################################################################################
#o          # #     #       #                                                   #           #         #   # #         # # # #       #   #
# # # ####### # ##### ####### ### ####### ####### # # ##### # # # ############### ####### ### ######### ### # ######### # # # ##### # # #
# # #   #                       #       #       # # #     # # # #                       #           # #     # # # # #     #       # # # #
# # ##### ############### ##### ### # ##### ########### # # # # # ########### ####### ### ##### # ### # ##### # # # # ##### ### ####### #
# #                     #     #   # #     #           # # # # # #           #       #   #     # #   # #       #               #         #
# ### ####### ####### ########### ### ### ##### ### # ### # # # # # ##### # ### ##### ####### ####### # ####### ### ### ############# # #
#   #       #       #           # # #   #     #   # #   # # # # # #     # #   #     #   #   #                     #   #             # # #
# ### # # ############### ### # ### ### # ####### # ############# # # # ### ### # ##### # ########### ########### # # ### ### # ####### #
#   # # #               #   # #       # #       # #             # # # #   #   # #     #   #     #   #           # # #   #   # #       # #
# # ### ### ##### # ######### ##### ### ##### # ### # ### ### ####### # # ######### # ##### ##### ##### ##### # ##### # ### ####### #####
# #   #   #     # #         # #   #   #     # #   # #   # # #       # # #         # # #               #     # #     # #   #       #     #
# ##### # # # ### ####### ### # ### ####### ######### ##### ####### ############### ### ##### ### ############### ### # ########### # ###
#     # # # #   #       #   #     #     # #         #             #               #         #   #   #           #   # #           # #   #
# ### # # ### ### # ######### ### # # ### ####### ##### ### # ##### # ####### ############# ### ##### ### # ########### # ######### # # #
#   # # #   #   # #         #   # # # # #       #     #   # #     # #       #       #     #   #         # #           # #         # # # #
# ### # # # # # ### # ### ############# # ##### ### ####### ### ####### # # ######### ### ######### # # ### ####################### # ###
#   # # # # # #   # #   #                     #   #       #   #       # # #         #   #         # # #   #                     #   #   #
# ####### ### ######### # # ####### # ### # ### ### # # # # # # # # ### ############# ########### ############# # # # ### # # # ### # ###
#       #   #         # # # #     # #   # #   #   # # # # # # # # #   #                         #             # # # #   # # # #   # #   #
# ### ### # # # ### ### # ### ### ### ##### ####### ####### # # ##### ####### ### # ### ### ############### # # ##### # ##### ##### # # #
#   # #   # # #   # # # #       #   #     #     # #       # # #     #       #   # #   #   #           #   # # #     # #     #     # # # #
# ### ### ### ####### ############# ### ######### ### ################# ### # ##### # ####### # # # ### ### # # # ### ### # # # ####### #
#   #   # #               #       #   #   #     #   # #               #   # #     # #       # # # #       # # # #   #   # # # #       # #
# ### # ### # # ### ####### ### ##### ##### ##### ##### ### # ########### ### ### # # # ### # # # # # # # ########### # ##### # # # # # #
#   # # #   # #   #           #     #                     # #           #   #   # # # #   # # # # # # # #           # #     # # # # # # #
# ### # # # # # ### ######### ### ########### # # # ##### ### # ##### # ##### ##### # ######### # ##### # ### ############# # # # # #####
#   # # # # # #   #         #   # # #       # # # #     #   # #     # #     #     # #         # #     # #   #             # # # # #   # #
# # ### ### # ##### ### ### ####### # ########### # # ######### ##### ### ##### ##### # ########### ### ######### # ############### ### #
# # #     # #     #   #   #                     # # #         #     # # #     #   # # #           #   #         # #               #     #
# # ### ### # # ####### # ##### # ### # ### ##### # # ########### ##### ##### # ### # # # ### ##### # ##### ### ######### # # ##### ### #
# # #     # # #       # #     # #   # #   #     # # #           #           # # #   # # #   #     # #     #   #         # # #     #   # #
# ### # # # # # # # ### ##### ### ### ### # # # ### ##### # ####### ######### # # ####### # ########### ### ##### ############# # # # ###
# # # # # # # # # #   #     #   #   #   # # # #   #     # #       #         # # #       # #   #       #   #     #             # # # #   #
# # # # # # # ### ### ##### ####### # ### ##### ### # # ####### ################# ### ######### ### # # # # ####### ######### ####### ###
# #   # # # #   #   #     #       # # # #     #   # # #       #   # #   #       #   # #           # # # # #       #         #       # # #
# # # # # # # # # ### # # # # # # # ### ### ### # ### # ########### # ### ####### ### # ######### # ### ### ### ##### ##### ##### ##### #
# # # # # # # # #   # # # # # # # #       #   # #   # #                             #           # #   #   #   #     #     #     #       #
# # ### # ### # # # # # ### ### # # # # ##### ############### # ### ####### ############# ########### ##### ### # # # # # # ### ##### ###
# #   # # #   # # # # #   #   # # # # #     #               # #   #       #             #           #   #     # # # # # # #   #     #   #
### ##### ### # # # # # ######### # ### # # # # ####### # # ############# ##### ####### ##### ######### ### ##### ####### ### # #########
#     #     # # # # # # #       # #   # # # # #       # # #             #     #       # #   #         #   #   # #     # #   # #         #
# # ##### # # # # ### ##### ####### # ########### # ### ##### ################### # ##### ######### ##### ### # ### ### ### ######### ###
# #     # # # # #   #             # #           # #   #     #                   # #               #     # # # #   #     # # # # #   # # #
# # # # # # # # # # # # ### # # ### ##### # ### # # ### # # # ##### ### ##### ######### # # # # ########### ### ######### ### # # ##### #
# # # # # # # # # # # #   # # #   #     # #   # # #   # # # #     #   #     #         # # # # #     # # #         # #       # #         #
# # # ### ### # # ### ####### # ### # ####### ### ### # # ### # ### # # ############# # # ####### ### # # ####### # # ##### # # #########
# # #   #   # # #   #       # #   # #       #   #   # # #   # #   # # #             # # # #   # # #             #         #           # #
### # # ##### ### # # # # ### # ######### ### # # ##### # # # # ### # # # # # ### # # # # # ### ### ########### # ####### ############# #
#   # #     # #   # # # #   # #         #   # # #     # # # # #   # # # # # #   # # # # # #                   # #       #         #     #
# # # ##### # ### # # ### # # # ##### ################### ### # ##### ##### # ####### # ### ##################### ### # ####### ### ### #
# # #     # # #   # #   # # # #     #       #           #   # #     #     # #   # # # #             #         # #   # #       #       # #
# # # # # # ##### ### # ####### ### # # # ### ############### # # # # ##### ##### # ##### ##### # ### ##### ### ##### ####### # # ### ###
# # # # # #   #   #   # #     #   # # # #                   # # # # #     #             #     # #         # #       #       # # #   #   #
# # ### ### # ### # # # # ############# # # ### ############# ### # # ### ### # # # # # ### # # ########### # ### ####### # # # ### # ###
# #   #   # # #   # # #               # # #   #             #   # # # # #   # # # # # #   # # #           #     #       # # # #   # #   #
# # # # # # ### # # # ##### ############# # # ### ##################### ############### ### # # # # # ### # ##### ##### # ### # # # ### #
# # # # # #   # # # #     #           #   # #   #             # #     # #             #   # # # # # #   # #   # #     # #   # # # #   # #
# # # # ### # # ### # # ### # # ### ### # # # ####### ######### # ##### # ########### # # # ### # # # ######### ####### # ##### # # #####
# # # #   # # # #   # #   # # #   #   # # # #   #   #                               # # # #   # # # #           #     # # #   # # #   # #
# # # # ### # # # # # # # # # # ############# ### ####### ############# # # # # ### ### ### ### # ### ### ####### ### ####### ####### # #
# # # #   # # # # # # # # # # # #       #               #             # # # # #   #   #   #   # #   #   #           #               #   #
# # # # ### # # # # # # ### ### # ####### # # # # ##### ##### # # # # # # # # ### ################# ### # ####### # ####### ### ### # # #
# # # #   # # # # # # #   #   #         # # # # #     #     # # # # # # # # #   #   #           # #   # #     # # #       #   #   # # # #
### # # # # ### ### # ##### # ### # # # ### # # ######### ### # # ####### # # ### ### ########### ####### ##### ####### # # ### # # #####
#   # # # # #   #   #     # #   # # # #   # # #         #   # # #       # # #   #                       #             # # # # # # #     #
### # # ####### # # # ##### # ### # # # # # # # ### # ### # ######### ### # ### ### # ##### # # ########### # ### ### ####### ###########
#   # #     #   # # #     # #   # # # # # # # #   # #   # #         #   # #   #   # #     # # #           # #   #   #                   #
# # ### ### # # ### # # ##### ##### # # # ### # # # # ### # ### ######### # ### ##### # ##### # ##### ########### ########### # # ##### #
# # #     # # # #   # #     #     # # # #   # # # # #   # #   #         # # #       # #   #   #     #           # #         # # #     # #
# # ### # # ### # # # ##### # # # # # # ##### # # ######### ### # ### # ### ### # ### ##### # # # # # # ######### # ########### #########
# #   # # # #   # # #     # # # # # # #     # # #         #   # #   # #   # #   #   #     # # # # # # # #       #             #         #
### # # # # # # ### # # ##### # # ####### # ### ############### # # # ######### # # # ### ##### ### # # # ############# # # #############
#   # # # # # # #   # #     # # #       # # #                 # # # # #       # # # #   #     #   # # #               # # #             #
### ### # # # ##### ##### ##### ######### ### # ### # # ### # # # # ### ### # # # # ##### # ######### # # # # # ### ############# # # # #
#     # # # # #         #   #           #   # #   # # #   # # # # #   #   # # # # #     # #       # # # # # # #   #             # # # # #
# # # # # ### ### # # # ####### # # # # # ##### # ##### # ##### ##### # ### ##### # # # ### # ##### ####### # # # # # # # # ####### # # #
# # # # #   # #   # # #     #   # # # # #   # # #     # #     #     #     #     # # # #   # #             # # # # # # # # #       # # # #
### ### # # ##### # # # # ##### # # ### # ### # # # # # ### # ### ####### # ########### ### # # ### # ######### ### # # # ###############
#   #   # # #     # # # #     # # #   # #   #   # # # #   # #   #       # #           #   # # #   # #         #   # # # #               #
### # # # # ##### # # # ### ### ### # ####### # # # # # # ##### ### # # # ########### ##### # # # # # ### ################### # # # # ###
#   # # # # # #   # # #   #   #   # #     # # # # # # # #     #   # # # #           #     # # # # # # # #                   # # # # #   #
### # ####### ##### # # ########### # # ### # ### ### # ### ### # ### ### # ##### ### # # # ### ### ### ##### ############# # ### #######
#   # #             # #           # # #     # #     # #   #   # #   #   # #     #   # # # #   #   #         #         #   # #   #       #
# ### # # # ### # # ### ### # # # ### ### ### ### ##### # # ### ### # ##### ##### ### # # # # # ### # # # ##### ####### ####### ####### #
# #   # # # #   # #   #   # # # #   #   #   #   #     # # #   #   # #     #     #   # # # # # #   # # # #     #   # #         #       # #
##### ##### ### # # # # ####### ##### # # # ### # ### # # # # # ######### # ######### # ### # # ### # # ### ####### # ##### ##### # # ###
#     #     #   # # # #       #     # # # #   # #   # # # # # #       # # #         # #   # # #   # # #   #               #     # # #   #
# # # ### # # # ### ### ### ### # # # # # ### # # # # ##### # ######### ### ####### # # ####### ### # ####### # ##### # # # # ### # # ###
# # # #   # # # #     #   #   # # # # # #   # # # # #     # #       #     #       # # #       # #   #       # #     # # # # #   # # #   #
### ##### ##### ### ### ### ### # ### ####### ### # # ### # ##### ### ##### ### ### # # ####### # # # ### ### # # # # # # # # ###########
#   #       #   #     #   # #   #   #       #   # # #   # #     #         #   #   # # # #     # # # #   #   # # # # # # # # #           #
# ##### # # # # ### # ##### ##### # ### ### ### # # # # ### # ##### ##### # ######### # # ########### ##### ### ### ### ### ####### # ###
# #     # # # #   # #     #     # #   #   #   # # # # # #   #     #     # #         # #           #       #   #   #   #   #       # #   #
# ### # # ##### ### ##### # # ### # ### # ### ### ##### ### # ### ########### ############# # # # ### # # ##### ####### ### ######### ###
# # # # #     # #       # # #   # #   # # # #   #   # # #   #   #           #             # # # #   # # #     #       #   #         #   #
# # # # # # # ### # ### ##### ### # ####### ### # # # ##### # # ####### ##### # # # ##### ### # # ### # # ##### # ######### ### # # # ###
# #   # # # # #   #   #     # #   #           # # #     #   # #       #     # # # #     #   # # #   # # #   #   #         #   # # # #   #
##### # # # ### ### # ################# # ################# # # ##### ####### # # # ##### ##### ### # # ### ### # ### # ### ##### ### # #
#     # # # #   # # #         #       # #                 # # #     #       # # # #     #     #   # # #   #   # #   # #   #     # # # # #
##### # # # ##### # ### ####### ### ####### # ############# ######### ########### ### ####### # # # # # # ### # ######### ### # ### # ###
#     # # # #         #           #       # #       #     #         #           #   #       # # # # # # #   # #         # # # #   # #   #
# # # # # # ##### # # # # ### ##### ######### ####### ##### ##### ####### # # ### ##### ##### ##### ##### ### # # # ### ### ####### #####
# # # # # # #     # # # #   #     #         # #         # #     #     # # # #   #     #     #   #       #   # # # #   #                 #
# # # # # # # # # # ### # # ### ######### # ### ######### ############# ############# ### ### ##### # ####### # # ##### ############# # #
# # # # # # # # # # #   # #   #         # #           #                             #   #   #     # #   # # # # #     #             # # #
# # # # # # ### # # # # # # ### ########### ####### # # ### # # # # ####### # ### # ####### # # ##### # # # ######### # ####### ##### ###
# # # # # # #   # # # # # #   #           #       # #     # # # # #       # #   # #       # # #     # #       #     # #       #     #   #
##### # ### # ### # ### # # # ### ### # ### ### ### # # ##### # # # # ### ### ### ##### ### ### # ### ### ##### ####### # ##### #########
#     # #   # #   # #   # # #   #   # #   #   #   # # #     # # # # #   #   #   #     #   #   # #   #   #   #         # #     #         #
# ### # # # # # # # # # # ### # ##### # ##### # ####### # ### ### # ##### ####### ### ### ##### ### # ### ### ##### # ### ####### # # ###
# #   # # # # # # # # # # #   #     # #     # # #   #   #   #   # #     #     # #   #   #     #   # #   #         # #   #       # # #   #
# # # # # # ##### # ### ##### # ####### ### ### # ### # # # # ### # ##### ### # # # # ######### ##### ### # # ######### ####### # ### ###
# # # # # # #   # # #       # #       #   # # #     # # # # #   # #     #   #   # # #         #     #   # # #         #       # #   # # #
### # # ### ### ####### ### # # # # ######### # # # ##### # # ### # ####### ### ######### # ########### ### ### ### # ### # ### # ##### #
#   # # #   #             # # # # #     #     # # #     # # #   # #       #   #         # #           #   #   #   # #   # #   # #   #   #
# # # # ########### # # # # ### # # # # # ######### # # ### # ### ### # ### # ### ### ### ##### ### # # # # # # ##### ### # ##### ### ###
# # # #   #         # # # #   # # # # #           # # #   # # #     # #   # #   #   # #       #   # # # # # # #     #   # #     #       #
# # # # ### # # # # # # # # ### ### # # # # ### ### # # # ### ### # # # # ##################### # # # ##### # # # ### ### ##### ### ### #
# # # #   # # # # # # # # #   #   # # # # #   #   # # # #   #   # # # # #                     # # # #     # # # #   #   #     #   #   # #
# ### # # ### # ### # # # # ##### # # # # # # # # ### ### ### ### # # ####### # ####### # # # ### ############# ##### # ##### ##### ### #
# #   # # #   # #   # # # #     # # # # # # # # #   #   #   #   # # #       # #       # # # #   # #         #       # #     #     #   # #
# ### ### # # # ##### ##### ### # # ### # ### # ##### ### # # ### # # # # # # # # ##### # ### # ##### ##### # # # ### ### ##### # ### ###
#   # #   # # # #       #     # # # #   #   # #     #   # # #   # # # # # # # # #     # #   # #     #     # # # #   #   #     # #   # # #
# ### # # ### ####### # # # # # # ### # # # # # ##### ### # # # # # ### # ### # # # ### # ### ##### # ### ##### # ### ### # ##### # ### #
# #   # # #   #       # # # # # #   # # # # # #     # # # # # # # #   # #   # # # #   # #   #     #     #   # # #   #   # # # # # # #   #
# ####### ##### # # # # ##### ##### # # # ##### ##### # ##### # ##### # ### # ####### ### # # ####### ####### # ### # ### # # # # # ### #
# #       #     # # # #   #       # # # #     #     #       # #     # #   # #       #   # # #       #         #   # #   # #     # # # # #
# # ##### # # ### # # # # ### # ####### ### # # ############# ####### # # ### # ### # ### # # # # # # # # ### ### ### ##### # # ##### # #
# # #     # # #   # # # # #   #     #     # # #           #         # # #   # #   # #   # # # # # # # # #   #   #   #     # # #       # #
# ##### # # # # # # # # ### # # # # ### ### # # ##### # # # # ### ##### # ####### # # ####### # ### # # # # # ############### ### ##### #
# #     # # # # # # # #   # # # # # #     # # #     # # # # #   #   # # #       # # #       # #   # # # # # #               #   # # #   #
# ####### ##### # ### # ### # # # # ### ####### ######### ### ####### ### ##### ######### # # # # # # # # ### ### # ### ### ### ### ### #
# # # #   #   # # #   # #   # # # # #     # #           # # #   # #     #     #         # # # # # # # # #   #   # # # # # # # # #   # # #
### # ### ### # # ### # ##### # ##### # ### ##### # # ##### ### # # ######### ### ##### ### # # ######### ### ####### ### ### ### ### # #
#         #     # #   #   #   #     # #         # # #         #             #   #     #   # # #         #   #                          x#
#########################################################################################################################################
