#########################################################################################################################################
#o      #                     #           # #                                           #   #     #               # # #     #       # # #
# # # ### ######### ### ### ### ########### # ####### ##### # # ### # ################### ### ##### ############### # # ##### ####### # #
# # #             #   #   # #           # #         #     # # #   # #           #   # # #               #   #             #             #
# ########### ### # ######### ########### # ##### ##### # # # ################### ### # # ############### ### ##### ####### ##### ### ###
#           #   # #   #   # # # #       #   #   #     # # # #       # #                 # # # # # # # #     #     #             #   #   #
# ##### ### # ######### ### # # # ####### ### ########### # ### ##### # ################# # # # # # # # ##### ############### ### # # # #
#     #   # #                         #                 # # # #           #   #   # # # # # #                               #   # # # # #
# # # # # # ####### ### # ### ### ####### ##### ### ######### ######### ### ### ### # # # # # ############### # ### ### ##### ####### ###
# # # # # #       #   # #   #   #             #   #                   #     #   #   # #   #   #       #     # #   #   #     #       #   #
# # ### # # # ##### ##### # ########### # ### ### # ####################### # ### ### # ### ### ### # # ########### # ### ######### #####
# #   # # # #     #     # #           # #   #   # #                   #   #           #           # #             # #   #         #     #
# # ### ##### # ### ### ### ### # # # # ### # ##### ################### ####### ####### ####### # ####### ### # ######### ####### ##### #
# #   #     # #   #   # # #   # # # # #   # #     #               #           #               # #       #   # #         #     # #     # #
### ####### # ### ####### # # # # # # # ##### ##### # # # # # ##### ############# ### ####### ##### ### # ########### # ####### ### # ###
# #       # #   #         # # # # # # #     #     # # # # # #     #   #         #   #       #     #   # #           # # #         # #   #
# # ######### # # # # ### # # # ##### # ########### # ##### ####### ### ####### # # # ### ####### ### ################### ####### ##### #
#           # # # # #   # # # #     # #           # #     #                   # # # #   #       #   #                           #     # #
### ##### # # # # # # # ### ############### # ##### # # # # # # ### ### # ############# ### # # ##### ############### ##### # ###########
#       # # # # # # # #   #               # #     # # # # # # #   #   # #             #   # # #     #               #     # #           #
# # ### ##### # ##### # # # ### ########### # # ########### # ### # ##### # ### ####### # # ############# # # ######### #################
# #   #     # #     # # # #   #           # # # #         # #   # #     # #   #       # # #             # # #   #     #                 #
# # ### # # # # ### # # # # # # ### # # ######### ########### # ### # ### ############# ### # # # ############### ####### # # # # ##### #
# #   # # # # #   # # # # # # #   # # #                     # # # # #   #             #   # # # #     #   #         #   # # # # #     # #
# # # ##### ####### ##### ### # # # ### # # ############### # ### # ##### # ### ####################### ### ######### ##### ##### # # # #
# # # #   #     # #     # # # # # #   # # #     #   #     # #   # #     # #   #       # # #                               #     # # # # #
### ### ######### ####### # # # ### ### # # ##### ### ##### ##### # ############# ##### # # ##### ##### ####### # ### # ##### # # # #####
# #                     # #   #   #   # # #               #       # #   #   #   #   # #         #     #       # #   # #     # # # #     #
# # ########### ### # ##### # # # ### # ### ### # # # ### ##### ### # ### ### ####### # ### ### # # # # ### ##### ##### # ##### # # ### #
#             #   # # # #   # # #   # #   #   # # # #   #     #   #                       #   # # # # #   #     #     # #     # # #   # #
# # ### ##### # ### # # ### # # ### ### ### ### ####### ### ##### # # ### # ##### ##### ######### # ### # # ##### # ##### ### ###########
# #   #     # #   # #     # # #   #   #   #   #       #   # #   # # #   # #     #     #         # #   # # #     # #     #   #           #
# # ### ####### # # # ### # # # # # ### ### # # ### # # # # # ##### # # # # ##### ####### ### # ####### # ### ### # ### ######### ##### #
# #   #       # # # #   # # # # # # # #   # # #   # # # # #       # # # # #     #       #   # #       # #   #   # #   #         #     # #
# # # ##### # # ##### # # ### # # # # ### # ### # # ### ####### ##### ### # # ######### ##### ####### # ### # # # # # ####### # # # #####
# # #     # # # #   # # # #   # # #     # #   # # # #         #     # #   # #         #     # #     # #   # # # # # #       # # # #     #
# # ##### # # ### ### ### # # ### ######### # ### # # # # ############# # # ##### ######### ### ##### ### # # # ### ### ####### # #######
# #     # # #       #   # # #   #         # #   # # # # #             # # #     #         #         #   # # # #   #   #       # #       #
### # ### ######### ### # # # # # # ####### # ### # ### # ####### # # # # # # ### # ####### # ### ### ### ### ##### ####### # ### # #####
#   #   #         #   # # # # # # #     #   #   # #   # #       # # # # # # #   # #       # #   # # #   #   #     #       # #   # #     #
### # ### # ########### ### # ### # # # ### # # ####### ### # ### # ##### ### ### # ##### ####### # ############### # ### ##### ##### ###
#   #   # #           #   # #   # # # #   # # #       #   # #   # #     #   #   # #     #       #                 # #   #     #     #   #
### # ####### ### ### # # ### ### # ######### # # # # # # # # ##### # # # # ### ### ### # # ######### ######### ### # ############### # #
#   #       #   #   # # # #     # #       # # # # # # # # # #     # # # # #   #   #   # # #     #   #         # # # #               # # #
# ### # # ### ##### ### ##### # ### # # ### ### # ##### # # # # ######### # ######### # # ### ### ##### ######### ####### ###############
# #   # #   #     #   #   #   #   # # #       # #   # # # # # #     #   # #         # # #   #         #                 #               #
# # # ### ### ### ############### # ### ### ### ##### ### # # # ### # ### # ##### # ### # # ##### ### # ### ### ### ### ####### # # #####
# # #   #   #   #               # # # #   # #           # # # #   #     # #     # #   # # #     #   # #   #   #   #   #       # # #     #
# # # ### ####################### ### # # # # # # # ##### # # ############# ### # ### ### ### ### ### # ############### # # ### ### #####
# # #   #                     # #   #   # # # # # #     # # #           # #   # #   #   #   #   #   # #               # # #   #   #     #
# # # ##### # # # # ##### # ### ########### # # # # # # # ### # # ####### # # # # ####### ### # # ############# ####### ##### # # # # # #
# # #     # # # # #     # #               # # # # # # # #   # # #         # # # #       #   # # #     #       #       #     # # # # # # #
# ### ####### ### # # # # # ##### # # ####### # # ####### ##### # # ####### ### # ### # # # # # ### ### ### # # # # ### # # ##### # ### #
# #         #   # # # # # #     # # #       # # #       #   #   # #       #   # #   # # # # # #   #       # # # # #   # # #     # #   # #
### # # # # ####### # # ########### ### ### # # # # ### # ##### # # ####### # ######### # ### # # # ##### # # # ### ##### ######### # # #
#   # # # #       # # #           #   #   # # # # #   # #   #   # #       # #     #   # #   # # # #     # # # #   #     #         # # # #
# # ### # # ### # # # ##### # ##### # # # ##### ### # # # ##### # # # # # ######### ##### # ### ### ####### ### # ### ### ##### ### # # #
# #   # # #   # # # #     # #     # # # #   # #   # # # # #   # # # # # #               # #   #   #       #   # #   #   #     #   # # # #
# # # # # # # # # # # # # # # ### ### ####### # ### # # ### ### # # # # # # # ##### # ############# ####### ### # # # # # # # # #########
# # # # # # # # # # # # # # #   #   # #     # #   # # #       # # # # # # # #     # #             #       #   # # # # # # # # #         #
# # # # # # # # # # # ### # # ### ##### ### # ### # # # # ### ### # # # # # ### # # # ### ########### # ### ### ### # ### # # # ##### ###
# # # # # # # # # # #   # # #   #         #     # # # # #   #   # # # # # #   # # # #   #           # # # #   #   # #   # # # #     #   #
# ### ### # # # # # # # ### # ############# # # # # # # # # ##### ### # # # # # ### ### # # # ### ### # # ############# ##### # ### # # #
#   #   # # # # # # # # #   #             # # # # # # # # #     #   # # # # # #   #   # # # # # #   # #               #     # #   # # # #
# # # # ##### ### # # ##### # # # ######### # ##### # # # # ### # # ##### # ### # ### # ### # # ##### # # # ######### # ####### # # #####
# # # #     #   # # #     # # # #         # #     # # # # #   # # #     # #   # #   # #   # #       # # # #         # #       # # #     #
# ### ### # # # # ### # # # ### ### ##### ### ### # # ##### ##### # ### # # ### ### ### ### ### ####### # # ##### # # # ######### # ### #
#   #   # # # # #   # # # #   #   #     #   #   # # #     #     # #   # # #   #   #   #   #   #       # # #     # # # #         # #   # #
# ####### # ##### ### ### # # # # # # ### # # ####### ################### # # ### # ####### ##### # ### ### # ### # ##### ### ###########
#       # #     #   #   # # # # # # #   # # #     #                     # # #   # #       #     # #   #   # #   # #     #   #           #
# # # # ### # # # # ##### # # # ############# ### ### ### ####### # # # ### # # # # ####### # # ### ### ##### # ### # # # ### # ####### #
# # # #   # # # # #     # # # #         #   #   #   #   #       # # # #   # # # # #       # # #   #   #     # #   # # # #   # #       # #
# # ############### # # # # # # ### # ### ##### # # # ### # # ##### # # ##### # # # # ### # # # # ####### ### ### # ### # # ####### # # #
# #               # # # # # # #   # #         # # # #   # # #     # # #     # # # # #   # # # # #       #   #   # #   # # # #     # # # #
# # ########### # ####### ### # ### # # ### ####### # ### ### ######### ### ##### ################# ### # ##### # ########### ##### #####
# #           # #       #   # #   # # #   #       # # #     #         #   #     #                 #   # # # # # #                 #     #
# # # ### ##### ### # # # # # # # # ################# ### ### # ### ##### ####### # # # # ##### ### # ##### # ###########################
# # #   #     #   # # # # # # # # #                 #   # #   #   #     # #     # # # # #     #   # #                               #   #
# # # # # ######### # ### ### ##### ### ### ### ##### # ##### # ### ####### ##### ####################### ################### ##### # ###
# # # # #         # #   #   # #       #   #   #     # #   # # #   #       #     #                       #           #       #     #     #
# # ##### # # ########### ### ##### # # # ##### ### ### ### # # ########### ############# # ########### ### ######### ### ############# #
# #   #   # #   #       #   # #     # # #     #   #   # #   # #                         # #           #   #   #   #     #             # #
### # ### ### ### ##### # # # ### # ### ### # ### ####### ##### ### # ####### ##################### # ##### # # ### ##### ##### ### #####
#   # #     #         # # # #   # #   #   # #   #             #   # #       #       #             # #     # # #       # #     #   #     #
# # ##### # # # # # # # # ##### ### # # ##### ##### # ### # ### ### ######### # # ### ####### # ####### ####### ####### ##### # ### # # #
# #     # # # # # # # # #     # #   # #   #       # #   # #   #   #         # # #           # #       #                     # #   # # # #
### # # # # # ### ##### # ### # # # # # ##### # # # # ##### # # ####### # ####### ########### ##### ##### ####### ##### # ### # ##### # #
#   # # # # #   #     # #   # # # # # #     # # # # #     # # #       # #       #           # #   #   # #       #     # #   # #     # # #
### # ### # ##### # ### # # # # # # # # # # # # # # # ##### # # # # # ### # # # ##### # ### # # ####### ### ### # # ### # ##### # # # # #
#   #   # #     # #   # # # # # # # # # # # # # # # #     # # # # # #   # # # #     # #   # #             #   # # #   # #     # # # # # #
### # # # # ####### ##### # # # # # # # ##### # # # # ####### ### # # ### # # ### ### ######### ####### # # ### # # # # ######### #######
#   # # # #       #     # # # # # # # #     # # # # #       #   # # #   # # #   #   #         #       # # #   # # # # #         #       #
# # # # # # # # # ### # # ####### # # # ##### ### # # # # # ### ##### ### ### ##### # # ### ### ### ### ### # # # # ### # ####### # # ###
# # # # # # # # #   # # #   # #   # # #     #   # # # # # # # #     #   # #       # # #   #   #   #   #   # # # # #   # #     #   # #   #
# # ### # # # ####### # # # # ##### # # ### # ### # # # # ### ##### # ### # # # ### # # # # # # ### ### # # ##### ##### ####### # # # # #
# #   # # # #       # # # #       # # #   # # #   # # # #         # #   # # # #   # # # # # # # # #   # # #     #     #     # # # # # # #
### # # ### # # # # ####### ### # # # # # ##### # ### # # # ### ##### ##### # # ####### # # ##### ##### # # # ### # # # # ### ####### # #
#   # #   # # # # #       #   # # # # # #     # # #   # # #   #     #     # # #       # # #           # # # #   # # # # #           # # #
# # ##### # # # # # # ### # # ### ### ### # ### ##### # # ### ### ######### ### ####### ####### # # # ### # # # ### # # ### # # # # # # #
# #     # # # # # # #   # # # # #   #   # #   # #     # #   #   #         # #         #       # # # #   # # # #   # # #   # # # # # # # #
# # # # # # # # # # # # ### ### # # # # # # # # # # # ### # # ### # ######### # # # # ######### ### ####### # # ##### # ##### # # # ### #
# # # # # # # # # # # #   #     # # # # # # # # # # #   # # #   # #         # # # # #         #   #     # # # #     # #     # # # # # # #
# # ### ##### # # ### # # # ##### ######### # ##### # # # # ### # # ### # ### # # ### ####### # ##### ### ### # # ##### ### ####### # # #
# #   #     # # #   # # # #     #         # #   #   # # # #   # # #   # #   # # #   #       # #     #   #   # # #     #   #       # #   #
# # ### # # # # # ### # # # # # # # # # ####### ### # # ### # # ### ####### ### # # # # ####### # ####### ##### # # ### # ##### # # #####
# #   # # # # # #   # # # # # # # # # #       # #   # #   # # #   #       #   # # # # #   # # # #           # # # #   # #     # # # # # #
### ### # ### # # # # # ### # ### # ##### # ### # # ### ### # ##### # ##### # # ##### # # # # ### # # ##### # ### # ### # ########### # #
#     # # # # # # # # # #   #   # #     # #   # # #   #   # #     # #     # # #   #   # #       # # #     #     # # # # #               #
### # # ### ### ####### ### # # ### # # ########### ### # # # # # # # # # ### # ##### # ### # ### ### ### ### ### # # ######### # ### # #
#   # #       #       # # # # #   # # #       # #     # # # # # # # # # #   # # #     #   # #   #   #   #   #   # #           # #   # # #
### ### # # ##### ### ### ### # # # # # # ##### ##### # ##### # # # # ##### ### # # # # # # ##### ### ########### ####### # ####### ### #
#     # # #     # # #     #   # # # # # # # #       # #     # # # # #     #   # # # # # # #     # # #           #       # #       # #   #
# # # # # ### # ### ######### # # # # # # # # ####### # ### # ####### # ### ##### # # # # # # # ### ##### ####### ##### ### ##### ##### #
# # # # #   # #           #   # # # # # #         # # #   # #       # #   # #     # # # # # # #         #       #     #   #     #     # #
# # # # # ### ### # # # # # # ##### # # # # # ##### ### # # # ####### ### # ####### # ### ##### ############################### # # #####
# # # # #   #   # # # # # # #     # # # # # #         # # # #       #   # #     #   #   #     #                       # # #   # # #     #
# # # # # # # ##### # ##### # ####### # # # # # # ##### # ####### # ##### # ##### # # # # # ### # # ### # # # # # ##### # # ### ### # ###
# # # # # # #   # # #     # #     #   # # # # # #     # #       # #     # #     # # # # # # #   # #   # # # # # #             #   # #   #
# # ### # ### ### ########### # # # ### ### ##### # # # # ####### ######### ######### # ####### # ### ####### # ####### # ######### ### #
# # #   #   #               # # # # #     #     # # # # #       #         #       #   #       # #   #       # #       # #       # #   # #
### # # # ### # # # # # # # ### # ### # # # # ### # # # # # ### ### ############# ### # # ##### ### # # # # ##### ### # ######### #######
#   # # #   # # # # # # # #   # # #   # # # #   # # # # # #   #   #             # #   # #     #   # # # # #     #   # #                 #
# # # # # # # # # # # # # # # ### ### ### # ##### ##### # ####### # # ##### ### # # # # # ### # # # # # # # ##### # # # # # ### ####### #
# # # # # # # # # # # # # # # # # # #   # #     # #     #       # # #     #   # # # # # #   # # # # # # # #     # # # # # #   #       # #
# # # # # ### # ####### # # # # ### # ### # # # # # # # ##### # # # # # ### ### # ### # ####### # # ### # # ##### ####### # # # # ##### #
# # # # #   # #     #   # # #       #   # # # # # # # #     # # # # # #   #   # # #   #       # # #   # # #     #     #   # # # #     # #
# # ### # ### # ####### ### ### # # # # ### ### # ### # # ### ##### ### ### ######### # ### # # # ##### ##### ########### ### # ### #####
# # #   # #   #     #     #   # # # # #   # #   # #   # # #       #   #   #         # #   # # # #     #     #           #   # #   #     #
# # ### # # # # # ##### # # ####### # # ##### # # # # # # # # # ### ### ########### ### # # # # # # ######### ### ########### ##### # ###
# #   # # # # # #   # # # #       # # #     # # # # # # # # # #   # # #           #   # # # # # # #         #   # #         #     # #   #
# ### ### # # # # ### ##### ### # ### # ### # # # # # # ##### ### ### # # ##### # ### # # ### ##### # # # ### ##### ### # # # # # # ### #
#   # #   # # # # #   #   #   # #   # #   # # # # # # # #       #     # #     # #   # # # # # #   # # # #   #         # # # # # # #   # #
# # ##### # ### ### ### ######### # # # # ### ##### # # ### # # ### ### # # # ### ### # ### # # ##### ### ############# # ######### #####
# # #     # # #       # #   #   # # # # #   #     # # #   # # #   #   # # # #   #   # #   # #       #   # # #         # #         #     #
# # ##### ### # # ##### # ### ### # # # # ######### ### ##### # ##### ####### ####### ### # # ############# # ########### ############# #
# # #       #   #               # # # # #         #   #   #   #     #       #       #   # #                             #             #x#
#########################################################################################################################################
