#########################################################################################################################################
#o                # # #       #         #         #             # #       # # # # #   #         # #     #       #     #         # # #   #
# ############### # # # ####### ######### ##### # # ####### # ### # ####### # # # ### # ######### # ##### ####### ##### ### ### # # ### #
#               #               # # #     #   # # #   #   # #   #     # # # # #                               #           #   #         #
# ### # # # # ##### ####### ##### # # ##### ####### ### ######### ##### # # # # ######### ########### ####### # ####### # ##### # # #####
#   # # # # #     #       #   # # #     #           # # # #   # #           #           #           #       # #       # #     # # #     #
# # # ### ##################### # # ##### ### # ##### # # # ### # ########### ##### ##### ##### # ##### # # ### ####### ### # # ### # # #
# # #   #       #       # #   #   #     #   # # # # #                             #     #     # # #   # # #           #   # # #   # # # #
# # # ### ####### ####### # ##### # ##### ####### # # ############# # ##### ################# ##### ##### # ########### #################
# # #   #                                       #                 # # #   #   #   #       # #           # #           # #               #
# ### ### ### # ######### ##### ### # ##### ##### ##### ############### ####### ### ####### ####### # ##### ### # # # # # ### ### ### # #
#   #   #   # #       # #     #   # #     #     # #   #                                           # #     #   # # # # #     # # #   # # #
# # # # # # # ### # ### ##### ####### # # # ### # # ################### ##### # # # ### # ### # ### ### ### # # # # ### # # # # ### # # #
# # # # # # #   # #         #       # # # #   #             #         #     # # # #   # #   # #   #   #   # # # # #   # # # #     # # # #
# # # ### ### # # ### ######### # # # ### # ### ### # ##### # ##### # # # ### ### # # ### # ### # # ### ##### # # # ### ### # ### # #####
# # #   #   # # #   #         # # # #   # #   #   # #   # #       # # # #   #   # # #   # #   # # #   #     # # # #   #   # #   # #   # #
# # # # # # # # # # # # # # # # ### ### ### # ########### ### # # # # ### ######### ##### # ############# # # ### # # # # ### ### # # # #
# # # # # # # # # # # # # # # #   #   # #   #               # # # # #   #         #   # # #             # # #   # # # # #   #   # # #   #
# # # # # # ### # # ### # # # # # ##### ### # ### ### ################# ######### # ### ### # # # # ### ### # ##### ### # ### # # # # ###
# # # # # #   # # #   # # # # # #   # #   # #   #   #                 # # #   # # #       # # # # #   # # # #     #   # #   # # # # #   #
# ####### # # ### # ######### # # ### ####### # # # # # ####### ### ### # # ### ####### # ####### # # ### ### # # ##### # ### ### ##### #
#       # # #   # #   #     # # #           # # # # # #       #   #   #           #   # # #     # # #       # # #     # #   #   #     # #
# ### # # # # # # # ### ### ### # # ##### ##### # ######### ####### ### ####### # # ####### ### ### # # ##### ####### # # # # ####### # #
#   # # # # # # # #       #   # # #     #   # # #         #       # # #       # #             #   # # #   # #       # # # # #       # # #
# ##### # # # ### ### # ### # # # ########### # ####### # # ######### ### ########### ### # ############# # ####### ### # # # ######### #
#     # # # #   #   # #   # # # #           #         # # #     #       #           #   # #             #         #   # # # #         # #
# # ### # # # ### # # # # # # # # ### # # # # # # ### ### # # ### ### ############# # ### ##### ################################# # ### #
# #   # # # # # # # # # # # # # #   # # # # # # #   #   # # #       # #           # # # #     #       #                         # #   # #
# # # # ### # # # # # # # ### # ### ### # ##### # # # # # ### ### ### ### ##### ### ### ############### ####### ####### #################
# # # # #   # # # # # # #   # #   #   # #     # # # # # #   #   #   #         #   #             #             #       #                 #
# # # ##### # # ######### ### ### ### # ##### # # ### # # # # # # ######### ### ##### # ######### ### # # # # # # ### ### ### ##### ### #
# # #   # # #           #   #   #   # #     # # #   # # # # # # #         #   #     # #             # # # # # # #   #   #   #     #   # #
### ### # ### # # # ####### # # # # # ### # # # # # # ##### ### # # # ####### ##### ### # ######### ### ##### # ######### ### # ### ### #
#     # #     # # #       # # # # # #   # # # # # # #     # #   # # #       #     #   # #         #   #     # #         # #   #   #   # #
### # ####### # ############# ### # # # # ### # # # ### # # # # # # ####### # ########### ##### ### ######### ##### # # ####### # # # # #
#   #   #     #             #   # # # # #   # # # # # # # # # # # #       # #           #     #   #         #     # # #       # # # # # #
### ##### # # # ########### ### # # ### ### ### ### # ############# ##### # # # ######### # # # ### ####### ##### ### # # ##### ### # # #
#     # # # # #           #   # # #   #   #   # #           #   # #     # # # #         # # # #   #       #     #   # # #     #   # # # #
# # # # # # # # # # # # # ####### ### ############# ### ##### ### # ####### ### # ### # ### ### # ### ### # # # ### # ### ##### #########
# # #   # # # # # # # # #       #   #           #     #           #       #   # #   # #   #   # #   #   # # # #   # # #       #     #   #
# # # # ##### # # ##### ####### # ########### ### # # ######### # ##### # # # # # # # ### # ##### # # # ### ### ####### # # ##### ### ###
# # # # #     # #     #       # #           # #   # #   #     # #     # # # # # # # #   # #     # # # #   #   #       # # # #   #       #
# ######### # # ####### ####### # ##### # ##### ### ### # ##### ##### ### # # ### ####### ### ##### # ##### # # # # ##### # # ####### # #
#       #   # #       #       # #     # #     # #     #       #     #   # # # # #     # #   #     # #     # # # # #     # #         # # #
# # # # # # ### # # ### # ##### # # ####### # # ### # # ### ### # # # ##### # # # # # # ####### ### # # # ### # ### # # # # # # # # # # #
# # # # # # #   # #   # #     # # #       # # #   # # #   #   # # # #     # #   # # #         # #   # # #   # #   # # # # # # # # # # # #
# # # ### # # # # # # # ######### ####### # ### # # # # # ####### ####### ### ############### ##### # ############# ### # # ### ##### ###
# # #   # # # # # # # #         #       # #   # # # # # #       #       #   #               #     # # #           # #   # # # #     #   #
# # # # # # # # # ### # # ### ### ### ############# # # # # ### # ### # # ### ##### # # # ##### # # # # ### # ####### # # # # # # # # ###
# # # # # # # # #   # # #   #   #   #           # # # # # #   # #   # # #   #     # # # #     # # # #     # #       # # # #   # # # #   #
# # # # ### ### # # # # # ### # # ### # ######### # # # ### ### # # ### # # # ### # # # # ### ####### ### ############### # # ### # #####
# # # #   # #   # # # # #   # # #   # #         # # # #   # # # # #   # # # #   # # # # #   #       #   #           # # # # #   # #     #
# # # ######### # ### # # # # # # # # # # # ##### # ### # # # # # # ### # # # # # # # # # # ######### # ############# # ############# # #
# # #       #   #   # # # # # # # # # # # #       #   # # #   # # #   # # # # # # # # # # #         # #               #             # # #
### # ####### # # ### # # # ##### # # # # # # ### ### # # ##### # ### ### # ### # ### # # # ### # ### # ############# # ####### #########
#   #       # # #   # # # #     # # # # # # #   #   # # #     # #   #   # # #   #   # # # #   # #   # #             #       # #         #
# ### # # # # # # # ##### # # # # # # # # ### ### # # ### # ### # # ### # # ### ########### ### # # # # ### # # ############# ### #######
# #   # # # # # # # #     # # # # # # # #   #   # # # #   #   # # #   # # #   #           #   # # # # #   # # #         #   #   #       #
# ### ### ### # # # ### # # # ####### ### # # # ##### # # # # # # # # ####### # # # ### ### # ### # ### ### # ### # ##### ### ###########
# #     #   # # # #   # # # #     #     # # # #     # # # # # # # # #       # # # #   #   # #   # #   #   # #   # #                 #   #
##### ### ### # # ##### # # # ### ### # # # ### ##### ### ### # # # ##### ### # ##### # # # # # # # # # ##### # # # ##### ##### ##### ###
# #     #   # # #     # # # #   #   # # # #   #   # #   #   # # # #     #   # #     # # # # # # # # # #     # # # #     #     #         #
# ### # # # # ### # ##### ##### # ### # ### ####### # ######### ################# ### # ### # # # # # # ##### ############# # # # # # ###
#     # # # # # # #   #       # #   # #   #         #     #   #           #     # #   #   # # # # # # #   #               # # # # # #   #
##### ######### # ##### # ### # ##### # ##### ##### # # ### ##### # # ##### ### # # # # ##### ### # # # ### # ### ### # ### ### # # # ###
#           #         # #   # #   #   #     #     # # #         # # #         # # # # #     #   # # # #   # #   #   # #   #   # # # #   #
##### # ####### # ##### # # ### ##### ### ##### ##### ##### ### ### # # # # # # # # # # # # # ##### ### ##### # ####### # ### # ### # ###
#     #       # #     # # #   #     #   #     #     #     #   # #   # # # # # # # # # # # # # #   #   #     # #       # #   # #   # #   #
##### # # # ##### ### # # ##### ##### # # # # # ##### ####### # ### # # ### ### # # # # ### ### ######### ### # # ### ### # # # # ### ###
#     # # #   #     # # #   # #   #   # # # # #     #       # #   # # #   #   # # # # #   #             #   # # #   #   # # # # #   # # #
# # # # # # # # # ##### ##### ####### # # ######### ### ### # # ### # ### # # ######### ### ##### ### ### # ### # # # ### # # ### # # # #
# # # # # # # # #     #           #   # #         #   #   # # #   # #   # # #         #   #     #   #   # #   # # # #   # # #   # # #   #
# ### # ### # ### # ### ### ######### # # # ##### ##### # ### # # # # # ######### # # # ### ### ##### ### # ##### ### ### # # ### ### # #
# #   #   # # #   #   #   #         # # # #     #     # # # # # # # # #   #     # # # #   #   #     # #   #     #   #   # # #   #   # # #
# ### # ### ##### ############### # # # # # # ##### # # ### ### ########### ### # ##### ### # ########### ### ### ####### # ####### # # #
# #   #   #   #                 # # # # # # #     # # #       #       #       # #   # #   # #         #     #   #     #   #       # # # #
# # # # ### # ### # ##### ### # ### # # # # # # ### # # ####### ####### ########### # ##### # # # ######### # ### # # ####### ##### # # #
# # # #   # #   # #     #   # #   # # # # # # #   # # #       #                   #       # # # #         # #   # # #       #     # # # #
### # # # # ####### # ### # # ##### # ### # # # # # ### # ### ### # # # ######### ##### # ### # # # # ### # # # # # ########### ##### # #
#   # # # #     #   #   # # #     # #   # # # # # #   # #   #   # # # #         #     # #   # # # # #   # # # # # # #   #     #     # # #
##### # ##### # ### ##### # # # # ####### ### # ### ### ### ### ### # # ### ### # # # # ### # # # # ####### # ####### ### ### # # ### # #
#     #     # #   #     # # # # #       # #   #   #   #   #   #   # # #   #   # # # # #   # # # # #       # #     #         # # #   # # #
### # # ##### ##### # ### ####### ### ####### # ##### # # ##### ### # # # # # # # ### ### # # # ### # # # # ####### ############# ##### #
#   # #     #   #   #   #       #   #     #   #     # # #     #   # # # # # # # # #     # # # #   # # # # #     #               #     # #
# # ### # ### ### # # ### ### # ######### # # # ### # # # # ### ######### # # # ### # ####### ### # ######### ### ### ########### # #####
# # #   #   #   # # # #     # #         # # # #   # # # # #   #         # # # # # # #       #   # #       # #       #           # # #   #
### ### ##### ##### # # # ######### ####### # # # # # # # # ##### # # # # ####### ####### ##### ##### ##### ##### ####### ############# #
#   #       #   #   # # #         #       # # # # # # # # #     # # # # #       #       # #   #     #           #   # # #   # # # #     #
##### # # # # # # # # # # ##### # ### # # ### # # # # ### # # # ################# ### ##### ############# ####### # # # ##### # # # #####
#     # # # # # # # # # #     # #   # # #   # # # # #   # # # #         #     # # # #   #         # #   # #     # #     #     #   #     #
# # # # # # # # ### ##### # ### ####### # ### # ### ##### # # # ### ##### ##### # # ##### ##### ### # ##### ##### ####### ##### ### ### #
# # # # # # # #   #   #   #   #       # #   # #   #     # # # #   #     #               #     #               # #                     # #
### # ### # # ### # # # # # # # # # # # # ##### ##### ### # ### # ### ### ####### # # ### ################### # ####### # # ####### #####
#   # #   # #   # # # # # # # # # # # # #     #     #   # #   # #   #           # # #                       #         # # #       #     #
### # # # # # ### # ### # # ### # ##### # ##### ### ####### ### # ### ##### # # ### # ##### # ### ##### ### ##### ### # # # # ####### # #
#   # # # # #   # #   # # #   # #     # #   #     #       #   # #   #     # # #   # #     # #   #     #   #     #   # # # # #       # # #
# # # # # # # ##### ### # # ### # # ### # ##### ######### # # # # # # # ##### # ######### ### # # # ##### # ##### # ### # # # ##### ### #
# # # # # # #   #     # # #   # # #   # # #   #         # # # # # # # #     # #         #   # # # #     # #     # #   # # # #     # # # #
# # # # ### # # ### # ### # # # # # ### ##### # ##### ### # ### # ### # # ### ####### ############# # ### # # # # ########### # # ### ###
# # # #   # # # #   # #   # # # # #   #   #         # # # #   # #   # # #   #       #             # #   # # # # #         # # # #       #
# ### # # # # # # # # # # # ##### ######### ### # ##### ### # ### # # # # ### # # # ### # ### # # # ####### ##### ######### #############
# #   # # # # # # # # # # #   # #       #   #   #       # # #   # # # # #   # # # #   # #   # # # #       #     #                       #
# ### # # # ####### ### # # # # ####### ### # # ### # # # # ##### # ### # # # ### # ### # ### # # # # ##################### # # ### ### #
# #   # # #   #       # # # #     # # # #   # #   # # #   #     # #   # # # #   # # # # #   # # # # # # #   #             # # #   #   # #
# ### # # # # # ### # # # # ####### # ### # ### ### ### # # # # # # # # # ### ### ### # # # ##### # # # # ### ####### ##### # # # # # # #
#   # # # # # # #   # # # #             # # #     #   # # # # # # # # # #   #   #     # # #     # # #               #     # # # # # # # #
# # # ### ##### # # # # # # # ######### # # # # # # # ### # # # # # # # # ### # # ### # # # ##### ##### # # # # ######### # # # ### # ###
# # #   #     # # # # # # # #         # # # # # # # #   # # # # # # # # #   # # #   # # # #     #     # # # # #   #     # # # #   # #   #
# ### # # # ### # # # # ### # # # # ####### # # ##### # # ### # ### # ### # # # # # ### ####### # # ### ### ### ### ############### ### #
#   # # # #   # # # # # #   # # # #     # # # # #   # # #   # # #   # #   # # # # #   #       # # #   #   #   #                 #     # #
# # # # # # # # # # # # ### # # # # # ### ### # ### ### ### ##### # # # # ### ##### ### # # ### # ### # ### ##### # # ############### ###
# # # # # # # # # # # # #   # # # # #       # #       #   #     # # # # #   #     #   # # #   # #   # #   #     # # #               #   #
# ### # ### ### # # # # ### # # # # # # ### ### # # # ########### ### # # ### # ####### ##### ##### # # ### # # # # # ########### # # ###
#   # #   #   # # # # # #   # # # # # #   #   # # # #           # #   # #   # #       #     #     # # #   # # # # # #           # # #   #
# # # ### # ### ####### ### ### # # ### ### ##### # # # ### # ### # # ### ### # # # # ### ### ### # ### # # # # ##### # # ### ### ##### #
# # #   # #   #     #   #     # # #   #   #     # # # #   # #   # # # #     # # # # #   #   #   # #   # # # # #     # # #   #   #     # #
# # # ### # ### # ##### # # # # # # ########### ### # # ##### # ######### # # # ####### # ##### # ##### # # # ### # # # # # ######### # #
# # #   # #   # # #     # # # # # #           #   # # #     # #     #     # # #       # #     # #     # # # #   # # # # # #         # # #
# # # # # # ### ### # # ### ##### # ### # ### ####### ### # # ##### ### # # # # # # # # ### # ### ####### # # # # # # ### # # # # # #####
# # # # # #   #   # # # #     #   #   # #   #       #   # # #     # #   # # # # # # # #   # #   #       # # # # # # #   # # # # # #     #
# # ####### # ##### # # # # # ### # # # # # ##### # # # # # ######### # # # # # # ##### # # ##### ##### # ######### ##### # # # # # # # #
# # #     # #     # # # # # # #   # # # # #     # # # # # #         # # # # # # #     # # #     #     # #         #   #   # # # # # # # #
# ### ### ### # ### # # # # # ### # # # # # # ####### ### # # ####### ### # # # # # ##### ####### # ####### ### ### # ### ### # ### ### #
#       #   # #   # # # # # #   # # # # # # # #     # # # # #       # #   # # # # #     # #     # #       #   #   # # #     # # #     # #
# ### # ##### ##### # # # # # # # # # ##### # # ##### # ### # ##### # ### ### # # ######### ####### ### # # # # # ### ### # # ##### ### #
#   # #   #     #   # # # # # # # # #   #   #       #     # #     # # #     # # #   # # #         # # # # # # # #   #   # # #     #   # #
# # # # ##### # ### ### ##### ### # ##### # # ### ##### # # # # ##### # # # ##### ### # # ########### ### # # # # ### ### # ### ### # # #
# # # #     # # #   #     #     # #     # # #   #     # # # # #     # # # #     #                       # # # # #   #   # #   #   # # # #
# # # # # # # ### # # # # ### # ### # ##### # # ### # # # # # # # # ##### # # ### ### ### # # # # # # # ####### # ##### # ### ##### # ###
# # # # # # #   # # # # # #   # #   #     # # #   # # # # # # # # #     # # # #     #   # # # # # # # #   #   # #     # #   #     # #   #
# ##### # ### ##### # # # ### # ### ### ### # # # ##### ### ### ####### # # ### # # ### ### # ### ### # # # ######### ##### ### ####### #
#     # #   #     # # # #   # # #     #   # # # #     #   #   #       # # # #   # #   #   # #   #   # # #           #     #   #       # #
# ####### # # # # # # # # # # ### # # # # # # # # ### # # # # ####### # # # ### # # # # # # ### ########### ### ############### # # # ###
#     # # # # # # # # # # # # #   # # # # # # # #   # # # # #       # # # # # # # # # # # #   #     #     #   #   #     #   # # # # # # #
# ##### # ##### ##### # # ### ##### # ##### ##### # # # ##### # ### ### # # # ### # ################# ### ##### ### ##### ### ##### ### #
#     #       #   #   # #   #   #   #     #     # # # #   #   #   #   # # # #     #                     #     #                   #    x#
#########################################################################################################################################
