#########################################################################################################################################
#o              # # #                   #   #     # # #     #     # #         # #                           # # #                       #
# # # ########### # # ####### ####### # # ### ##### # # ##### ##### # ######### # ########### # # ### ### ### # # ########### ##### #####
# # #                       #       # # # # #       # # #     # #   #                       # # #   #   # #   #   #   #     #     # # # #
# ##### # # # ######### ##### ### ####### # # ####### # # ##### # ### ######### ####### ########### # ##### ### ### ### ####### # ### # #
#     # # # #         #     #   #               # #   #       # #             #       #           # #   # #               # # # # #   # #
# ### # # ######### ### ##### ################### # ### ##### # # ####### # ################# # # ### ### # ############### # ##### ### #
#   # # #         #   #     #               #               #           # # #               # # # #   #                 #       #       #
# # # ### # # # ############### # ########### ############################### ### ### # ##### ######### ##### ########### ### ### #######
# # #   # # # #               # #                               #               # # # #     #     # #   #   #               #           #
# ##### # # # # ############# # # ### ### # ########### ######### ############# ### ######### ##### ### # ############### # #############
#     # # # # #             # # #   #   # #         # # #                 #   # #   # #     # # #   #                   # #             #
# # ### # # # # ### ### ### # ### # ##### ### ####### ### ##### # # # # ### ##### ### # ### ### # ### ######### # # ### ####### ### # ###
# #   # # # # #   #   #   # # #   #     #   #           #     # # # # # #                 #                   # # #   #       #   # # # #
# ### # # ### # # # ### # # ####### # ### # # ##### ##### ##### # # # ### ### ### ##### ### # ######### # ######### # # # # # ### # ### #
#   # # #   # # # #   # # #   # #   #   # # #     #           # # # #       #   #   # #   # #         # #         # # # # # #   # #     #
# ##### # ### # # # # # ####### ##### ##### # # ### ##### # ### # # # # # ########### ########### # ### ##### # # # ##### # # # # ##### #
#     # #   # # # # # #     #       #     # # #   #     # #   # # # # # #                       # # #       # # # #     # # # # #     # #
# # ##### # # ##### # # # ### ##### # # # # # ##### # # ##### ### ### # # ### ### ### # ### ##### ##### # # # # # ####### # # # # ### # #
# #     # # #     # # # #         # # # # # #     # # #     #   #   # # #   #   #   # # # #     #   #   # # # # #       # # # # #   # # #
### # ### ##### # # # ####### # ### ####### # ##### ### # # # ####### # # ##### # ####### ##### # ### # # ##### # ### ### # ### # # # ###
#   #   #     # # # #       # #   #   #   # #     #   # # # #       # # #     # # #           # #   # # # #   # #   #   # #   # # # #   #
# # # # ######### # # # ####### ####### ### ######### ### # # ####### ### # # # # # ####### ########### # # ### # ##### ### # ######### #
# # # #         # # # #       #           #         #   # # #       #   # # # # #         #     #     # #     # #     #   # #         # #
### ##### ### # # ### ### ########### # ### ############# ####### ### ### ### # ### ##### ####### ######### ### # # # ### ### # ### ### #
#       #   # # # # #   #           # #   #         #   #       #   #   #   # #   #     #                 #   # # # #   #   # #   # #   #
# # ##### # # ##### # ##### ##### # # # ### # # ##### ### # ### ##### ### # ### ### # # # ### ############### ### # ####### # # ### ### #
# #     # # #     #       #     # # # #   # # #         # #   #     #   # #   #   # # # #   #     #         #   # #       # # # # #   # #
# # # # ######### ### # ##### ########### # # # ######### # # ### ######### ### # # # # # ### # ### ### # ##### # ### ### ####### ### ###
# # # #         # #   #     #           # # # #         # # #   #         #   # # # # # #   # #       # #     # #   #   #       #   #   #
# # # # # # ######### ####### ### # ### # ##### # # # # ### # # # # # # # ### # ##### # # # # # ####### # ##### ### # ####### ### #######
# # # # # #       #         #   # #   # #     # # # # #   # # # # # # # #   # #     # # # # # #       # #     #   # #       #         # #
# ### ### # # # ##### ### # ##### ##### ### # ### ### # ### ####### ##### ### # ### # # # ############### # # # ### ##### # ####### # # #
#   #   # # # #   #     # #     #     #   # #   #   # # # #       #     #   # #   # # # #               # # # #   #     # #       # #   #
# # # ### # # ##### # # ### # ##### ### # ####### # ##### ##### ####### ####### # # ##### ##### ##### ### ### # # ##### ### ####### #####
# # #   # # #     # # #   # #     #   # #       # #           #       #       # # #     #     #     #   #   # # #     # #         #     #
# # # # # # # # # # # # # # # ### # ##### ### ######### # ######### ### ##### # # # ### ######### ####### ### # # # # ### # ### # #######
# # # # # # # # # # # # # # #   # #   # #   #         # #         #   #     # # # #   #         #       #   # # # # #   # #   # #     # #
# # ### # # ### ##### # # # # # # ### # ####### ### ### # # ####### # # # # # ### # # # # ##### # ############# # # # ##### # ####### # #
# #   # # #   #     # # # # # # #   #         #   #   # # #       # # # # # # #   # # # #     # #             # # # #     # #       #   #
# # # ### # ### ##### # # # # # ##### ##### # ### ### ######### ### ####### ##### # # # # ### ### ### # ### ############# ### ##### # ###
# # #   # #   #     # # # # # #     #     # #   #   #         # # #     #       # # # # #   #   #   # #   #             #   #     # #   #
# # # ### # # # ##### # # # # # ##### ### # # ### # # # ### ### # # ##### # ##### # ##### # ### ### ######################### # # #######
# # #   # # # #     # # # # # #     #   # # #   # # # #   #   # # #   # # #     # #     # #   #   #             #           # # #       #
# # # # # # # # ### # ### # # # # ### ####### # # ### ##### # # # # ### ####### # # # # # # ######### ### ####### ####### ###############
# # # # # # # #   # #   # # # # #   #       # # #   #   # # # #   #           # # # # # # #         #   #             # #               #
# # ### # # ### # ### # # ### # # # # # ##### ### # # # # ############# ### ####### # # ### # # ### # ### ####### ### # #################
# #   # # #   # #   # # #   # # # # # #     #   # # # #     # #       #   # # #   # # #   # # #   # # # #       #   #                   #
# # # # ### # ### # # # # ################# ##### ##### # ### # ##### # ##### # ########### # ### # ### ################# ##### # ##### #
# # # #   # #   # # # # #                 #     #     # #         # # # #       # # #     # #   # #                     #   # # #     # #
# # ### # # ##### # # # # # ############### # ##### # # ####### ### ##### ####### # # ### # # ### # # ########### ### ### ### ### # #####
# # #   # #     # # # # # #               # #     # # #       #                         # # #   # # #           #   #   #       # #     #
### ### # # ####### ####### ### ########### ##### # # # # ################# # ### ########### ### ##### # ##### ####### ####### # # # ###
#   #   # #       #     #     #           #     # # # # #                 # #   #           #   #     # #     #       #       # # # #   #
### # # # # ####### ####### ############# ### # # # # # # # # ####### ##### ############# # ######### ########### ### # # # #############
#   # # # #       #   #                 #   # # # # # # # # #       #     #             # #     #   #           #   # # # #             #
# ### # ### ##### # # # # # # # ##### # ############# # # # # ####### # ### # ####### # # ##### # ### # ### ### # # # # ##### ####### # #
# #   # # #     # # # # # # # #     # #             # # # # #       # #   # #       # # #     #     # #   #   # # # # #     #   #   # # #
### # ### # # # ########### # # ### # # # ########### ### ### ############# # ### ##### # ### # # ##### ##### ######### ### # ### #######
#   #     # # #           # # #   # # # #     #     #   #   #             # #   #     # #   # # #     #     #         #   # #           #
# # # # # # # # # # # # # ### ### # # ### # ### ########### # # # ########### ### # ##### ##### # ### # # # # ##### ### ##### # ### # ###
# # # # # # # # # # # # # #     # # #   # #       #       # # # #       #   #   # #     #     # #   # # # # #     #   #     # #   # # # #
# ### # ### # # ####### # # # # ##### ######### ### ##### ### # # # ### # ########### ### # # ### ######### # ######### # ### # # ##### #
# #   #   # # #       # # # # #   #           #         #   # # # #   #             #   # # #   #     #   # #         # #   # # # #     #
### # # ##### # # ##### ### # ####### ### ### # ######### ### # # # ### # ####### ### ### ### ### ##### ##### # # ### # ####### # # ### #
#   # #     # # #   #   #   #     #     #   # #         #   # # # #   # #       #   #   #   #   #           # # #   # #     #   #     # #
# ### # # # # ##### ### ### # # # # # # # # ### # # # # # ### # # # # ########### ############# # ### # ### # # ### ##### ##### # ### # #
# #   # # # #     #   # #   # # # # # # # #   # # # # # #   # # # # #           #     #     # # #   # #   # # #   #     #     # #   # # #
### # # # # # # ####### # # ##### ### # # # ### # # ### # # # # # ##### # # ########### ##### ### # # # ####### # # # # ### # ### # #####
#   # # # # # #     # # # #     #   # # # # #   # #   # # # # # #     # # #                     # # # #       # # # # #   # # #   #     #
### # # # ### # # ### ##### ### # ### # # # ##### # # # # ### # # ####### ##### # ### # # ##### # # # # ### # # ### # # ######### # # # #
#   # # #   # # #         #   # #   # # # #     # # # # #   # # #     # #     # #   # # #     # # # # #   # # #   # # #         # # # # #
# # # ### # ### ##### # ### ### # # ##### ####### # ### # # ### # ##### ##### # # # ### # ##### ### # # ############### # ####### ### ###
# # # #   #   #     # #   #   # # #     #       # #   # # #   # #           # # # #   # #   # #   # # #               # #       #   #   #
### # ### # # # # # # # ### # ### ####### ##### # ### # # # ### # # ####### ####### # ### # # ### ### # ### ########### # ##### # # # # #
#   #   # # # # # # # #   # # #         #     # #   # # # #   # # #       #       # #   # #     #   # #   #           # #     # # # # # #
##### ### # ##### # # # # ### # # # ##### # # ##### ### # # ##### ### ### # # ####### ### # ######### # ####### ### ##### ### ##### ### #
#       # #     # # # # #   # # # #     # # #     #   # # #     #   #   # # #     # #   # #         # #       #   #     #   #     # # # #
##### ### # ##### # ########### # # # ### # # ######### # # ##### ######### ####### # ### ##### ##### # ### ################### # ### # #
#       # #     # #           # # # #   # # #       # # # #     #         #         #   #     #     # #   # #         #       # # #   # #
##### ##### ### # # # # # ####### # # ### # # ####### # # ### # # # ####### ### # # ##### # ### ### # # # ### ####### # ########### #####
#     #       # # # # # #     #   # #   # # #         # #   # # # #       #   # # #     # #   #   # # # #           #                   #
# ### # ### # # # # # # # ##### # # # # # ### ### ##### ##### ### # ### ### ##### # ##### # # ### # # # # # # # ### ######### # #########
# #   # #   # # # # # # # # #   # # # # #   #   #     #     #   # #   #   #     # # #   # # #   # # # # # # # #   #         # #         #
##### ### # # # # # # # # # ### # ### ####### # # ##### # ##### # # # # ######### # # ##### ####### ##### ############### ####### # # ###
#     #   # # # # # # # #     # #   #       # # #     # #     # # # # #       #   #       #     # #   #     #           #       # # # # #
### # # # # # # ### ### # # ##### ##### ##### ### # ### ##### ### ##### ######### # # # ##### ### ####### # # ##################### ### #
#   # # # # # #   # #   # #     #     #     #   # #   #     #   #     #         # # # #     #   # #     # #           # #         # # # #
# # # # # ### ### # ### # # ##### # # # # ##### # ##### # ####### # # ######### ### # # # ####### # ############# # ### # ##### # # # # #
# # # # # #     # #   # # #   #   # # # #     # #     # #     #   # #       # #   # # # #     # # # # # #       # #           # # #     #
### # # ### # # # # ### ### # ### # ########### # # ### ### ### # ### # # ### ####### # ##### # # # # # # ############# #################
#   # # #   # # # #   #   # #   # #           # # #   #   #   # # #   # #           # #     #                         #                 #
##### # # # # # # # ### # # # ##### ### # # ### ### # # # # ##### # # # ### # ### ####### ########### # # # ######### ####### # # # # ###
#     # # # # # # #   # # # #   #     # # #   #   # # # # #     # # # #   # #   #     # #           # # # #         #       # # # # #   #
##### # ### # # ### ### # # # # ### ##### # # # # # ### # # ### # # # # ### # # # ##### ############# ### ##### # # # # # # # ### # #####
#     # #   # #   #   # # # # #   #     # # # # # #   # # #   # # # # #   # # # #                   #   #     # # # # # # # # #   #     #
### # ### # # # ### ### # # # # # # ##### ##### # # # # # # # # # ### # ### # # # # # # # ##### # # # # # # # # ### # # ##### ######### #
#   #   # # # #   #   # # # # # # #     #     # # # # # # # # # # # # #   # # # # # # # #     # # # # # # # # #   # # #     #         # #
# # # # # # ### ####### # # # # ### ### # # ### # # ##### # # # # # # # ### # ### # # ### # # ### ### ### # # # ####### # ####### #######
# # # # # # #       #   # # # # #     # # #   # # #     # # # # #   # #   # # #   # #   # # #   #   # #   # # #       # #       #       #
# # # # ### ### ### # # # # # # # # # ############# # ### # # # # # # # ##### ##### ### # ### ####### ### # ### ##### # # # # ###########
# # # #   #   #   # # # # # # # # # #             # # #   # # # # # # #     #     #   # #   #       #   # #   #     # # # # #           #
# ### ##### ### ### ### ##### # # # # # ####### # ### ##### # # # # ### # # # # ### # ### ### # ### # ##### # # # # # # # ####### # # ###
# #       #   #   #   #     # # # # # #       # # #       # # # # #   # # # # #   # #   #   # #   # #     # # # # # # # #       # # #   #
# ### # ### ### ### # # # ### ##### # # # ### ### # # # # # ##### # ### # # # # # # # ##### # # ### # # ##### ### ############# # ### ###
# #   # #     # #   # # #   #     # # # #   #   # # # # # #     # # #   # # # # # # #     # # #   # # #   # #   #             # #   # # #
##### # # # ### ##### # # ### # ### # # # ########### ### # # # # ####### # # # # # # ### # # # ### # # ### ### # ##################### #
#     # # # #       # # # # # #   # # # #           #   # # # # #     #   # # # # # #   # # # # # # # #       # #                       #
# ### ### ### # # ##### ### # ##### # ### # ####### # ### # # # # # # ### ### ####### ##### ### # ####### # # ### # ######### ### ### ###
# #     #   # # #   #       #     # #   # #       # #   # # # # # # # #     #       #     #   #       # # # #   # #         #   #   #   #
# ### # # # # # # ##### # # ############# ### # ##### # ### # # # # # ### ### # # ### ### ##### ####### ### # ####### ########### ##### #
#   # # # # # # #   #   # #             #   # #     # # #   # # # # # # #   # # #   #   #   #             # #       #           #     # #
# ### ### # # # # ### # # # ##### ### # # ####### ### # ### ##### ### # # ### # # ####### # # # ### # ### ### # # ### ####### ###########
# #     # # # # #   # # # #     #   # # #       #   # # #       #   # #     # # # #     # # # #   # #   #   # # #   #       #           #
### # # # # # # # # # # ### ##### ### # # ####### # ##### # # # ####### # # ##### # ### ####### # ### # # ##### # # # ################# #
# # # # # # # # # # # # #       #   # # #       # #     # # # #     #   # #   # #     #       # #   # # #     # # # #                 # #
# ### # ### ### # # # # ### # # # ####### # # # ### # # # # # # # ### ### # # # ##### ######### ##### ### # # # ### # ##### ########### #
#     #   # #   # # # # #   # # #   #   # # # #   # # # # # # # #   # #   # #       #         #     #   # # # #   # #     #           # #
# ### ### # # # ### ### ### # # # ### ### # # # # ### # # # # # # # # ### # # ### # # ######### ####### # ### # ### # ### # # ### ### ###
# #     # # # # #     # #   # # #       # # # # #   # # # # # # # # # #   # #   # # #         #       # # # # #   # #   # # #   #   #   #
# # # # ### ### ### ### # # # # # # # ##### ##### ##### # # # # # ### # # # # ##### # # # ### # # ##### # # ####### # ####### ### # # # #
# # # #   # #   #     # # # # # # # #     #     #     # # # # # #   # # # # #     # # # #   # # #     # #         # #       #   # # # # #
##### ### # # # # # # # ### ### ##### # ### ### # ##### # # # # ####### # # # ####### # # ####### ##### # # # ### ### # # # # ###########
#       # # # # # # # # #     #     # #   #   # #     # # # # #     #   # # #       # # #       #     # # # #   # #   # # # #       #   #
##### # # # # ### ### ### # # # # # # # # # # # # ##### ### ### ### ### # # # ####### ### # # ####### ### # ##### ### # ##### ### # # ###
#     # # # #   #   #   # # # # # # # # # # # # #     #   #   #   #   # # # #       #   # # #       #   # #     # #   #     #   # #     #
# ### ### # # ### ### ##### ### # ######### # ### # # ##### ### ### # ####### ##### # ##### # ####### ### ####### ### # ##### ### # ### #
# #     # # #   #   # #   #   # #         # #   # # #     #   #   # # #           # #     # #       #   #       # # # #     #   # #   # #
### # # ### # ### ####### # ##### ####### # # ##### ##### # # # # # ####### # # ### # ##### # # # # ### ####### ### # ### # ##### # # # #
#   # #   # #   #     #       #         # # #     #     # # # # # #     #   # #   # #     # # # # #   # #     #     #   # # #   # # # # #
# # # ### # # ### # ##### # ##### # ####### # ############# # ### # # ### # # # ### ### # ### # # # ##### ######### # ####### ##### #####
# # #   # # #   # #     # #     # #       # #             # #   # # #   # # # #   #   # #   # # # # #   #   # #   # #     #     # #     #
### ### # ### ### # # # # # # # # ### ### ##### ### ####### # ##### # # ### # # ### # ####### # ##### ### ### # ### ####### ##### #######
# #   # # # #   # # # # # # # # #   #   #     #   # # #   # #     # # # #   # #   # #     # # # # #               #             # #     #
# # # ### # # ### # # # ### # ### ### ####### # ### # # ######### # # ### # # # ### # # ### # # # # ################# ########### # #####
#   # #   #   #   # # # #   # #     #       # #   #             # # #   # # # #   # # #     # #                     #                  x#
#########################################################################################################################################
