#########################################################################################################################################
#o                #           #     #           #                   # #   # #             # #   #   #   #     #                     #   #
# # # ### ##### ##### ### ##### ##### ##### ##### ######### ######### # ### # ### # ### # # # ### ### ### ##### ##### ############### ###
# # #   #     #         #                 # # #         # #                     # #   # # #     #   #             # #   #               #
# # # ### # ##### ##### ######### # ######### # ##### # # ### ####### ######### # # ####### ##### ### ######### ### ##### ###############
# # #   # #     #     #         # #                 # # # # # #     #         # # #     #   # # #   #         # #                       #
# # # ### # # ####### ##### # # ######### ##### # ##### # # ### ######################### ### # # ### ########### ### # #################
# # #   # # #       #     # # #         #     # #     #                 #   # # # # # # #                           # #     #           #
# ### ### # # # ### ### # # # # ############### ############### # ####### ### # # # # # # ############### ############# ### # ###########
#   #   # # # #   #   # # # # #             # #               # #     # #     #                         # #           # # #             #
# ##### ### # # # ####### # ####### ### # ### ######### ### # ### # ### # ##### ##### ### ########### # ### ### ##### ### ############# #
#     # # # # # #       # #       #   # #             #   # # #   #                 # # #           # #       # # # #               # # #
# ### ### # ##### # # ### # ##### ####### # ######### # ##### ### ### # ####### ####### ##### # ### ### ######### # ####### # # ##### ###
#   #   # #     # # #   # #     #       # #         # #     #   #   # #       #       #     # #   #   #                   # # #         #
# # ##### # ##### ### # # # # ##### ### ####### # # ############# ### ### # ########### ### ### # # # ########### ### ### ##### # #######
# #       #     #   # # # # #     #   # #     # # #   #         #   #   # #               #   # # # #           #   #   #     # #     # #
# # # ##### # ####### # # # # # ##### ### ### # # ##### ####### # ##### # ##### ##### # # # ### ### ### ##### # # # # # # # # # # # # # #
# # #     # #       # # # # # #     #       # # #         #   # #     # #     #     # # # # # # #     #     # # # # # # # # # # # # #   #
### # # ### ################### ### ### # ############# ### ##### # # # ### ############# ### ############### # # ### ##### # ### # #####
#   # #   #                 #     #   # #             #         # # # #   #         # # #                   # # #   #     # #   # #     #
### # # # # # ################# ### # # ####### ### # # # # ################# # ##### # ##### ##### # ####### # # ### ##### # # ### ### #
#   # # # # #               #     # # #       #   # # # # #                 # #     #   # # # #   # #       # # #   #     # # #   #   # #
# # # # # # # # # ### # ### # # # # # ##### ### # # ### ### # # # # # # # ######### # ### # ### ####### # ##### # # # # # # ### # # ### #
# # # # # # # # #   # #   # # # # # #     #   # # #   #   # # # # # # # #         #                   # #     # # # # # # #   # # #   # #
# ### # ### # # # ##### ##### ##### # # ##### # # # ### ### # ### ### ########### ####### # ### ##### # # ####### ### ##### # # ### #####
# #   #   # # # # #   #     #     # # #     # # # #   #   # #   #   #         # #       # #   #     # # #     #     #     # # # # #     #
### # # # ### # # # ############### # # ####### # ##### # # # ### ####### ### # ######### # ### # # ##### # ##### ### ########### # #####
#   # # # #   # #                 # # #       # #     # # # #   #       #   #           # #   # # #     # #     # # #             #     #
# # # # # # # ### # # ### ######### ### # ####### # # ####### # # # # ### ##### ##### # # # ### # # # # ######### # # # ##### # # # ### #
# # # # # # # # # # #   #         #   # #       # # #       # # # # #   #     #     # # # #   # # # # #         #   # #     # # # #   # #
# # ##### # # # # # ### ####### ##### # # ####### # # ##### # ### # ############### # # # ##### ### # ####### ##### ##### # ### ### # ###
# #     # # # #   #   #       #     # # #       # # #     # #   # #               # # # #     #   # #       #     #     # # # #   # #   #
# # ### ### # ### # ######### ### ####### # ##### # ##### ### # # ##### # # # ########### # ### # # # # # # # # # ########### ##### ### #
# #   #   # # #   #         #   #       # #   # # #     # # # # #     # # # #     #     # #   # # # # # # # # # #     #           #   # #
# ######### # ##### ##### ############### ##### # # # # ### ####### ### # ##### ### ####### # # ##### # # # ########### ### ### ### ### #
#         # #   #       #   #           #       # # # #           #   # #     # #         # # #     # # # #               #   #   #   # #
# # ##### # # ##### ### ##### ##### # ##### ####### # # ### ### ########### ### # ######### # ######### ### ####### ### # # # ##### # ###
# #     # # #   #     #           # #     #       # # #   #   #           #   #         # # #         #   #       #   # # # # #   # # # #
# # ##### ### ##### ### ### ### # ### ### # ### ### ### ##################### # ####### # # # ### # ### # ############### # ### ####### #
# #     # #   #       #   #   # #   #   # #   #   #   #                     # #       #   # #   # #   # #               # # #   #   #   #
### ### ##### # ### # # # # # ### ### # # ### # # # # ########### ### # # ##### # # ############# # ####### # ### ####### ### ### ### ###
#     #     # # #   # # # # #   #   # # #   # # # # #           #   # # # #   # # #       #     # #       # #   #     # #               #
# # # ####### # ### # ### ####### # # ### # ### ### # ### # # # ####### # # ##### # ### ### ### ################### # # # # # # # # # # #
# # #       # #   # # #         # # #   # #   # # # #   # # # #       # #     #   #   #       #                   # #   # # # # # # # # #
# # # # ##### # # # # ### ### ####### # # ####### ### # # ### # ### # ### ### # # ####### # ############### # # ####### # # ### # ### # #
# # # #     # # # # # #     #       # # #     #   #   # #   # #   # #   #   # # #       # # # # #         # # #       # # #   # #   # # #
# # # # # # ### ##### # # ### # # ##### ### # # ##### # ##### ####### ### # ##### # ######### # # ####### ### # # ### ######### # ### # #
# # # # # #   #   #   # #   # # #     #   # #       # #     #       #   # #   #   #                     #   # # #   #         # # #   # #
# # # # # # # # ##### # # # ### # ##### ### ##### # # # ##### # ### # ########### # # # # ### ### ############### # ### ####### ##### ###
# # # # # # # #   #   # # #   # #     #   #     # # # #     # #   # #         # # # # # #   #   #               # #   #       #     # # #
# # # # # # # ### ### # # ####### # # ##### ##### ### # ##### ################# # ### ### ##### # ### # # ####### # # ##### # ######### #
# # # # # # #   #   # # #       # # #     #     # #   #     #       #           #   #   #     # #   # # #       # # #     # #           #
### # # # ### # # ### # # ############# ############# # ### ### ##### ### ### # ####### # # # ### ### # # # ##### ######### # # ### # ###
#   # # # #   # #   # # #             #           #   #   #   #         #   # #       # # # #   #   # # # #     #         # # #   # #   #
# # ##### ### # # # # ### ########### # ### ##### ### # # # ### ### ### # # ##### ### # ##### ### # ### # ######### ### ##### # # # ### #
# #     # #   # # # # #             # #   #     #   # # # #   #   #   # # #     #   # #     #   # #   # #         #   #     # # # #   # #
### ####### # # # # # ### # # ####### # ### # # ### ### ### ### ### ### # # # ### ### # # ##### # ### # # ### # # ################# # # #
# #       # # # # # #   # # #       # #   # # #   # #     #   #   #   # # # #   #   # # #     # #   # # #   # # #                 # # # #
# # ### ##### ### ### # # # ########### ### # # # ### # # ##### # # # ############### # ### # ### # # # # ##### ##### # # # # # ##### # #
#     #     #   # #   # # #           #   # # # #   # # #     # # # #               # # # # #   # # # # #     #     # # # # # #     # # #
# # # ####### ####### ##### ### ### # # # ### # # # ### # ######### # # # ##### ####### # ### ### ### ### ### ################# ### ### #
# # #       #   #         #   #   # # # #   # # # # #   #         # # # #     #       #     #   #   #   #   #                 #   #   # #
### # # # ### ####### # ### # # # # ### # # # # # # ### # # ##### # ### ##### ### ##### # ######### ### ### # # ########### ### ####### #
#   # # #   #   #     #   # # # # #   # # # # # # # #   # #     # #   #     #   # # # # #     #   # # #   # # #           #   #       # #
### # # # ### ##### # # # ### # ### # ##### ### # ### # # # ### ### # # # # # ##### # ######### ##### ####### ####### ############# # ###
#   # # #   #   #   # # #   # #   # #     #   # #   # # # #   #   # # # # # #         # #     #             #       #   # # #     # #   #
# # # # # # # ####### # ####### # # ######### # # # ### # # # # # # ####### ##### ### # # ##### ################# # ### # # # ###########
# # # # # # #   #     #       # # #         # # # # #   # # # # # #       #     #   #                 # #       # # # # #             # #
# # ########### ##### # ##### # # # # # ### ### # ##### # # # # # ##### ### # ##### ####### # # # # # # # ### ##### # ### ############# #
# #           # #     #     # # # # # #   #   # #   #   # # # # #     #   # # #   #       # # # # # #       #     #                     #
# # ################# # # # ### ### # # ### # ### # # # # # ### ### # ### ### # ### # # ### # ### ######### # ######################### #
# #           #       # # #   #   # # #   # #   # # # # # #   #   # #   # #       # # #   # #   #       # # #                         # #
### # ######### # # # # # ### ### # # ##### ##### # # # # # ##### ### ### ### ### ### # # ##### ######### ################# # ##### #####
#   #       #   # # # # #   #   # # #     #     # # # # # #     #   #   #   #   #   # # #     #                           # #     #     #
# # # ### ####### # # # # # # # # # # # ########### # # ### # ### ### # # ### ### ### # # # # ### ######### ########### # # # # # # # ###
# # #   #       # # # # # # # # # # # #   #   #   # # # #   #   #   # # #   #   #   # # # # #   #         #           # # # # # # # #   #
### # # # # ##### ### # # # # # ### ####### ### ### ### # # # ######### # ### ########### # ### # ######### ##### ### # # # # # ### # ###
#   # # # #     # #   # # # # #   #         #     #   # # # #         # # #             # #   # #         #     #   # # # # # #   # #   #
# # # ### # # # # ### # # # # # ### # # ### # ########### # # # # ##### # ### ####### ##### # # # ##### # # ### ########### ##### ### ###
# # #   # # # # # #   # # # # #   # # #   #       #     # # # # #     # #   #     # #     # # # #     # # #   #           #     #   #   #
# # # ### ##### ### # # # # # # ### ### # # # # ### ##### # ### ####### # # # ### # ##### # # # # ### # ### # ##### # ##### ######### # #
# # #   #   # #   # # # # # # #   #   # # # # #         # #   #       # # # #   #       # # # # #   # #   # #     # #     #         # # #
# # # # # ### ##### # # # # ### ### # # # ##### ##### ### # ### # ####### # # # # # # # ### ### # # ##### # ##### # ### ############# ###
# # # # #         # # # # #   #   # # # #     #     #   # #   # #       # # # # # # # # #     # # #     # #     # #   #             #   #
# # # # # # ### ### ### # # # # ### ### # ##### ####### ### # # # ### ### ### # ########### # # # # # # ### ##### ####### ##### ### # ###
# # # # # #   #   # #   # # # #   #   # #     #       #   # # # #   #   #   # #           # # # # # # # #       #       #     #   # #   #
# # # # ### ####### # # # # ### # ### # # # ### # ### # # # # # ####### # # # # # # # # ### # ### # # ### # ### ############### # # # # #
# # # # #         # # # # # #   #   # # # #   # #   # # # # # #       # # # # # # # # # #   #   # # #   # #   #               # # # # # #
# ####### # # # ### # # # ##### # ### # ### # ####### # ### # ### ##### ####### # ##### # # # ### # # ### # ### ##### # ### ##### # ### #
# #     # # # #   # # # #   #   #   # #   # #       # #   # #   #     #       # #     # # # #   # # #   # #   #     # #   #     # #   # #
# # ### # # ### # ##### # ##### ### ### # ### # ### ####### # # ########### ### ### ####### ##### # # ##### ### # ### # # ##### ### # ###
# # #     #   # #   #   #     #   #   # #   # #   #       # # #           #   #   # #     # #   # # # #       # #   # # #     #   # #   #
# ####### # ### ####### # # # # ##### ### ### # ### # # ##### # ##### ### ##### # ### ####### ### # # ### # # # # # ### # ### ##### ### #
# #       #   #     #   # # # #     # #     # #   # # #   #   #     #   #     # #               # # #   # # # # # #   # #   #     #   # #
# # ### # ############# # # # # # ### ### ### # ##### # ##### # ####### # # ### # # ####### # ######### # # # # # ### ### # # # ##### ###
# # #   #           #   # # # # #   #   #   # #     # #   #   #       # # #   # # #       # #         # # # # # #   #   # # # #     #   #
# # ### # # ####### # # # # # # # # # ### # ### ### # # # # # # # ##### ### ### ######### # # # # # # # # ##### # ##### ##### # ### # ###
# # #   # #       # # # # # # # # # #   # #   #   # # # # # # # #   # #   #   #         # # # # # # # # #   #   #     #     # #   # #   #
### ### # # ### ##### # ### ### # # # # # # # # # # # ### # # # # # # ##### # ### # # ### # # ##### # ### ##### # # # # ### # # ### #####
#   #   # #   #     # # #     # # # # # # # # # # # #   # # # # # #       # #   # # #   # # #     # #   #     # # # # #   # # #   #     #
# ### ### ######### ##### # # # # # # # # # # # # ########### ### ########### ### ### # ##### # ### ##### ### # # # ######### # #########
# #   #           #     # # # # # # # # # # # # #           # #             #   #   # #     # #   #   # #   # # # #         # #   #     #
# ####### # # ### ####### # # # # # ##### # # # # # # ### # ##### ### ### ##### # ### ### # # ### ### # ### # # ############### ### #####
# #       # #   #       # # # # # #     # # # # # # #   # # #       #   #     # # #     # # #   # # #     # # #               #         #
# # # # # # # ### ### ### ### # ### # ### # ### # # # # ### # ### ############### ### ### # ####### ### # ######### # # ####### # #######
# # # # # # #   #   #   #   # # #   # #   #   # # # # #   # # #             # # #   # # # #           # #         # # #     #   #       #
####### # # # # # # # ### # # ##### ##### # ### # ### # # # # # # # # # ##### # # # ### ####### ##### ### # # # # # # ### # ### # ##### #
#       # # # # # # #   # # #     #     # # #   #   # # # # # # # # # #         # #           #     #   # # # # # # #   # #   # #     # #
##### # # # # ### ##### ### # ### # # # ####### # ### ### # ### # # # ######### ### # ### # # # ### # ####### # # # ##### # ### # # #####
#     # # # # #       #   # #   # # # #     #   #   #   # # #   # # #         #   # #   # # # #   # #       # # # #     # # #   # #     #
##### # # # # # # # ####### # ##### # # ##### # # ##### ####### # ### # ####### # # # ####### # # # ########### # # ##### # ### # # # # #
#     # # # # # # #       # #     # # #     # # #     #     #   #   # #       # # # #       # # # #           # # #     # #   # # # # # #
# # # # # # # ### # # # # ### ######### # ### # # # # ### # ### # # # # ####### # # # # ####### ##### # ##### ### ########### ### # ### #
# # # # # # # #   # # # # #           # #   # # # # #   # #   # # # # #       # # # # #       #     # #     #   #           #   # # #   #
##### # # # # # # # # # # ### # ####### # ### # # # ### ### ### # ### # # # # ### # # ####### # ### # # # # # ### # # # # ### # ### #####
#     # # # # # # # # # #   # #       # #   # # # #   # # # #   #   # # # # #   # # #       # #   # # # # # #   # # # # #   # #   #     #
# # # # # ### ### ### # # # ### ### ##### # ### ### ### # # ### # # ### # # # # # ### # ### # # # # ### ### # ### # # # # # # # ### # # #
# # # # # #   #     # # # # #     #     # #   #   #   # #     # # #   # # # # # #   # #   # # # # # #     # #   # # # # # # # #   # # # #
# # # ##### ### # ### # # ### # # # ##### # ### # # ####### # # # # ### # # # # ### # # ##### # ### # # # ### ### # ### ########### # # #
# # #     # #   #   # # #   # # # #     # #   # # #       # # # # #   # # # # #   # # #     # #   # # # #   #   # # #           # # # # #
# ### # # ### # # # # # # ### # # # # # # ##### # # # ### # # # # # # # ### ### # ### # # # # # # ### # ##### ### ##### ######### ### # #
#   # # # # # # # # # # #   # # # # # # #     # # # #   # # # # # # # #   #   # #   # # # # # # #   # #     # # #     #             # # #
# # # # # # # # # # # # # ### ### ### # # ##### # # # ######### # # ### # # # # # # # # # # # # # ##### # ##### # # ### ########### ### #
# # # # # #   # # # # # #   #   #   # # #     # # # #       #   # #   # # # # # # # # # # # # # #     # #       # # #             #   # #
# # ### # # # # ### # # ### # # # # # # # # ### # ### # ##### # ### # ##### ######### # ### ##### # ################### ########### ### #
# # #   # # # #   # # #   # # # # # # # # #   # # # # #   #   #   # #     #       # # #   #     # #                 #             #   # #
# # ### # # # # # # # # ####### # # # # # # ### ### # ### ##### ### # ### # # # # # ### # # ### ### ### # # ### # ### # # # ##### # # # #
# #   # # # # # # # # #       # # # # # # #   # #       #   #     # #   # # # # #     # # #   #   #   # # #   # #   # # # #     # # # # #
# ##### ### # # ### # # # ### ### ### ### # ### ##### # # ### # # ####### # # ### # ### # # ### # # # # ### # ######### # # # # # # ### #
#   #     # # #   # # # #   #   # #     # #   # #     # #   # # #       # # #   # #   # # #   # # # # #   # #         # # # # # # #   # #
# ##### # # # # ### ### ####### ######### ### ##### # ######### ### # ### # ### ### # ### # # ### # # ### ### # ##### ### ### ### # # # #
#   #   # # # # #   #         # # #     #   #     # #         #   # #   # #   #   # #   # # #   # # #   #   # #     #   #   #   # # # # #
# # # # ### # # ####### ######### ### ### # # # ### # # ### ### # ### ### ### # ####### # # # ########### ### # ##### ### ### # ##### # #
# # # # #   # # #         #     # #     # # # #   # # #   # # # #   #   #   # #       # # # #           #   # # #   #   #   # #     # # #
# ##### # # # # ##### # ### ##### # ##### ##### ##### # ##### # ####### # ### ##### # ### # # # ### ####### ##### ### ############### # #
#   #   # # # # #     #                 #     #     # #       #       # #   #     # #   # # # #   #       #         #               # #x#
#########################################################################################################################################
