#########################################################################################################################################
#o      #         # # # # #   #                               #   # # # #               #             #           #                     #
# # # ### ####### # # # # # ### ############################### ### # # # ############# # ############# ########### ####### # # # # ### #
# # #           #                               #             #                       # #                     # # #       # # # # #   # #
# ### ### ######### ### # # # ### ### ### # # # # ############# ####### ################# ##### # ### ### ##### # # ####### # # # ##### #
#   #   #         #   # # # #   #   #   # # # #             #     #   #                       # #   #   #     #           # # # #     # #
# # # # ####### ####### # # # # ### ### # ######### # ####### ##### ######################################### # ##### # #################
# # # #       #       # # # # #   #   # #         # #                           # #   # # # # #             #       # #     # #   # # # #
# # # # # # # ### ### ##### # # # # # ####### # # ######### # # # # ####### ##### # ### # # # # ### ############# ### # ##### # ### # # #
# # # # # # #   # # #     # # # # # #       # # #         # # # # #       #                       #             #   # #                 #
# # # # # ### ### # ######### # # ######### ### # ##### # ### ### ############### ######### # ################# ### # ##### # ##### # ###
# # # # #   #   #           # # #         #   # #     # # # #   # #             #         # #                 #   # #     # #     # #   #
# # # # # ### # ####### ### # # # # ##### # # # # # # ##### ####### ##### ### ######### # ### ##### # ##### ### # ##### ### # ### # # # #
# # # # #   # #       #   # # # # #     # # # # # # # #                 #   #         # #   #     # #     #   # #     #   # #   # # # # #
# # # ### # # ######### ### # ##### # ####### ######### ################# ####### ### # ############# ### ### # # ##### ### ######### ###
# # #   # # #         # # # #     # #       # #                         #       #   # #             #   #   # # #     #   #       # # # #
### # # ##### # # # # ### ##### ### # # ####### ############### ### ####### # ### # ### # # # ##### ######### ##### ######### # ### # # #
#   # # #     # # # #         #   # # #                       #   #       # #   # #   # # # #     #         #     # #       # #     # # #
### # ##### # # # # ### # # ########### ####### # ##### ####### ### ### ### # ##### # # # # # ### ### ### # ######### ####### ######### #
#   #     # # # # #   # # #           #       # #     #       #   #   # #   #     # # # # # #   #   #   # #     # # #   # # # # #       #
### # ##### # # # # # # # # ### ##### # ### # ### ####### # # ####### ####### ####### # # # ### # # ##### # ##### # # ### # ### # #######
#   #     # # # # # # # # #   #     # #   # # #         # # #       #       #   # # # # # #   # # #   # # #                             #
# # # # ##### # ### # # # # ### # # ### # # # # # # # # ##################### ### # ####### # # # # ### ### ################### # # ### #
# # # #     # # # # # # # #   # # #   # # # # # # # # #                     #         #   # # # # #   #   # #                 # # #   # #
# ### # # ### ### ##### # ### ##### ### # # # ### ### # ########################### # # ##### ######### ##### ############# ######### ###
# #   # # # #         # #   #     #   # # # #   #   # #                           # #   # #                 #             #         #   #
# ### # # # # ####### # # ### ####### # ##### ### ##### ##### ##### ##### ############### # # ### ### ####### ####### ### ##### ### ### #
# #   # #   #       # # #   #       # #     #   #     #     #     #     #                 # #   #   #               #   #     #   #   # #
# # # # # # # ### ##### ### # ### # # ### ### ### # ### ### # # # # ### ########### ### ##### ################# # # ### ####### #########
# # # # # # #   #     #   # #   # # # # #   #   # #   #   # # # # #   #       #   #   # # # # #               # # #   #   #   #       # #
### ### # # # # # ##### # ### # # ##### ##### ### ### # # ### # ### # ####### # ######### # ### ### # # # # # # # # ####### ##### # ### #
#     # # # # # #     # #   # # #           #   #   # # #   # #   # #       #                     # # # # # # # # # #           # #   # #
# # # ### ##### # # # # # # # # # # ########### ####### # # # # ### ### ### # # # # # # ##### # ##### ##### # # # # # ### ### ######### #
# # #   #     # # # # # # # # # # #           #       # # # # #   #   #   # # # # # # #     # #     #     # # # # #     #   #           #
# # # # # # # # # ##### ##### # # ### ####### ######### # ### # ##### # ### ####### # ### # # # ### ######### # ### # ##### # ### ### ###
# # # # # # # # #     #     # # # # # # #   #         # #   # #     # #   # #   # # #   # # # #   #         # #   # #     # #   #   #   #
# # # # # # # # ##### # ##### ##### ### # ######### ##### # ##### ### # ##### ### ### ### ### # ### # ############# # # ### ##### #######
# # # # # # # #     # #     # # #                 #     # #     #   # #             #   #   # #   # #   #         # # #   #     #       #
# # # # ### # # # # # # ### ### # ##### ### # ### ### # ####### # # # ####### # ##### ##### # # # # # # # ########### # # # ### # ### ###
# # # #   # # # # # # #   #           #   # #   #   # #   #   # # # #       # #     #     # # # # # # #     # #     # # # #   # #   #   #
# ### # # ### # # # # # # # ### ### ### ####### ####### ### ########### ### ### ##### ### # ### ##### # # # # # ########### # # # # ### #
#   # # # #   # # # # # # #   #   #   #       #       #               #   #   #     #   # #   #     # # # #               # # # # #   # #
# ### # ##### # # # ### # # # # # # ##### ############# ##### ####### ##### ### ### # ############### # ######### ##### # ####### # # ###
#   # # #     # # #   # # # # # # #     #         # # #     #       #     #   #   # #               # #         #     # #     #   # #   #
# ### # ### # # # # # ### # ### # # # # # ### ##### # ####### # # ### ##### # ### ### ##### # ##### # # # ### ############# ##### # # ###
#   # #   # # # # # # #   #   # # # # # #   #               # # #   #     # #   #   #     # #     # # # #   #             #     # # #   #
# # # # # ### # # # # # # # # # ### # ### ### # # ######### ### ##### # ### # ##### ### ### # ### ##### ### # # ### ### # ###############
# # # # # #   # # # # # # # # #   # # #     # # #         #   #     # #   # #     #   #   # #   #     #   # # #   #   # # # #     #     #
# ##### # ### # # # ### # ### # # # ### # # # # # # # # ### ######### # ##### # ################# # # # # ### # # # # ##### # ##### #####
#     # # #   # # #   # # #   # # #   # # # # # # # # #   #         # #     # #                 # # # # # # # # # # #                   #
# ##### # ##### # # # # # # # # # # ##### ### ####### # # # # # ### # # ######### # ### ############### # # # ### ########### ##### ### #
# #   # #     # # # # # # # # # # #   #     #       # # # # # #   # # #         # #   #               # # # #   #           #     #   # #
# # ### # # # # # # ### # # # # ##### ### # # # ### ####### # # # # ### # # # # ### ### ########### ####### ####### ### ### ### ### #####
#     # # # # # # #   # # # # # #   #   # # # #   #       # # # # #   # # # # #   #   #           #               #   #   #   #   #     #
# ### # # ##### # ##### ### # # # ##### # ### ##### # ####### ##### ### ##### # # ####### # ######### # # # # ####### # ### ##### # ### #
#   # # #     # #     # #   # #       # #   #     # #       #     #   #     # # #       # #         # # # # #       # #   #     # #   # #
# # # # # # # # # # ##### ### # # # ### # ### # ### # # # # ### # # ### # ### # # ### ##### ### ##### # # # # ### # ####### ### ### #####
# # # # # # # # # #     # #   # # #   # # #   #   # # # # #   # # #   # #   # # #   #     #   #     # # # # #   # #     # #   #   #     #
# ######### ##### # ### # ### # # # # # # ### # # ### ##### # # # # ##### # # ##### ### # ### ### ### ### # # # ##### # # ##### ### #####
#         #     # #   # # #   # # # # # #   # # #   #     # # # # #     # # #     #   # #   #   #   #   # # # #     # #     # #   #     #
# # # # ### # # # # ### # ### # # # ### # # # # # ### # ### ####### ##### ##### ### # # ### ################### # # ### # # # ###########
# # # #   # # # # #   # # #   # # #   # # # # # #   # #   #     # #     # #   #   # # #   #                   # # #   # # # #           #
# # # ##### # # ##### ##### # # # # # # # # # ### ### # ######### # ### # # ### ### ### # ##################### ######### ### ##### #####
# # #     # # #     # #     # # # # # # # # #   #   # #           #   # #     #   #   # #             #     # #         #         #     #
# # ### ##### ############### # # ### # ### # # # # ### # # ############# # ####### ######### ##### ### ##### ### ########### ##### ### #
# #   #     #         # # # # # # #   #   # # # # #   # # #           #   #       #         #     #             #           #     #   # #
### # # ####### # # ### # # # # # # ### ### # # # # ### ####### ### ### # # ####### ### # ######### # # # # ############# # ### ##### # #
# # # #       # # #       #   # # # #     # # # # #   #       #   #   # # #       #   # #         # # # # #             # #   #   # # # #
# # # # # ### # ### ####### # ### # # # ### # # # # # # ##### # # # ####### ############# # ####### ### # # ############### # # ### ### #
#   # # #   # #   #     #   #   # # # #   # # # # # # #     # # # #     #             #   #       #   # # #               # # #       # #
# # # # # # # # ### # # # # # # # # # # ### ### # # # # ##### # ##### ##### ##### ####### # ######### ### ### ### # ### # # # # # # # ###
# # # # # # # #   # # # # # # # # # # #   #   # # # # #     # #     #   #       #       # #         #   #   #   # #   # # # # # # # # # #
# ### # ### # # # # ### # # # # ### ### # # ### # # # # # ### # ##### # # # # # ##### # ######### # # ### # ### # # ### # # # # # # # # #
# # # #   # # # # # #   # # # #   #   # # # #   # # # # #   # #     # # # # # #     # #         # # #   # #   # # #   # # # # # # # #   #
# # # # # ### ### # # # # # # # # # ### # # # # # ### # # ##### # ##### # ### # # ##### ##### # # # # ### ### # ### ### # ### ####### ###
#   # # #   #   # # # # # # # # # #   # # # # # #   # # #     # #     # # #   # #     #     # # # # #   #   # #   #   # #   #       #   #
# # # ### # ####### # ### # # ### # # # # ### # ### ### # ### # # # ##### ### # # # # # # # # ### # # # # # # ######### # # # ####### # #
# # #   # #       # # #   # #   # # # # # #   #   #   # #   # # # #     #   # # # # # # # # #   # # # # # # #         # # # #       # # #
# # # # ### ##### # ##### # # ### # ### # ### # # # ### # # # # # # ##### # # # # ##### # # ######### ### # # # ##### ##### ### # # # ###
# # # #   #     # #   #   # # #   #   # # #   # # #   # # # # # # #     # # # # #     # # #         #   # # # #     #     #   # # # #   #
# # # ### # # # ##### # # # # ### # # ### ### # ##### # # # # # # ### ### ### # # # ### # # # # ### # ### # # # # # # # ### ### ##### ###
# # #   # # # #     # # # # #   # # # #     # #     # # # # # # # # #   #   # # # #   # # # # #   # #   # # # # # # # #   #   #     #   #
# # # ##### ##### # # # # # # # # # # ### # # ########### # # ##### ### # ### # ### # # # ### ##### # ### # ### ### ####### ####### # # #
# # #     #     # # # # # # # # # # #   # # #     # #   # # #         # #   # #   # # # #   #     # #   # #   #   #       # #     # # # #
# # # # ### ##### ### # # # # # # # # ### ### ##### # ### # ############# ############# ####### # # # # # ########### ### # # ###########
# # # #   #     #   # # # # # # # # #   # #             # #             #             #       # # # # # #           #   # #             #
# ### # ### # # # # # ### # # # ### ##### ### # # # ### ### # ####### ##### # # # ##### ### ####### # ### # ####### # # ### # # #########
#   # # #   # # # # # #   # # #   #     # #   # # #   #   # #       #     # # # #     #   #       # # # # #       # # #   # # # #     # #
# ### ##### # ####### # # # # # ### ##### # # # # # ### ####### # # ##### # ########### # ### # # ### # # # # ### ### ##### ### # ##### #
#   # #     #       # # # # # #   #     # # # # # #   #       # # #     # #           # #   # # #   # #   # #   #   #   #     #       # #
# # ##### # ### # # ####### # # ### ##### # # ### # ### # ### ##### ### ############# ####### # ### ##### # # ####### # ### ### ### ### #
# #     # #   # # #     # # # # #       # # # #   #   # #   #     #   #             #       # #   # #   # # #       # # #     #   #     #
# ### ##### # # # # # ### # ### ### ####### ### # # ### ########### ##### ### # ### # # ### ### ### # ##### # ### ##### # # # # # # # # #
#   #   #   # # # # #   #     # #         # #   # # # #           #     #   # #   # # #   #   # #         # #   # #   # # # # # # # # # #
# ##### ### ### ### ### # # # ##### # # # # ### # # # ### # # ##### # ### # # ####### ### # ### ####### # # # # ### ##### # ### # #######
#     #   #   #   #   # # # #   #   # # # # #   # #     # # #     # #   # # #   # # # # # #   #       # # # # # #       # #   # #       #
# # # ### # ### ####### # # ##### # # # ### ### # # # # # ### ### # # ########### # ### ####### # ########### ### ### ####### ### # # ###
# # #   # #   #       # # #     # # # #   # #   # # # # #   #   # # #                         # #           #       #       #   # # #   #
# # # # # # # # ##### ### # # # # # # # # # # # # # # # ##### ### # # # ### ##### # # # # ######### ### # ##### # ##### # # # ### # # # #
# # # # # # # #     # #   # # # # # # # # # # # # # # #   #     # # # #   #     # # # # #         #   # #     # #     # # # # #   # # # #
# ### ### # # # ### ### # # # ##### # # ### # ### ### # # ### # # # ### ### ### ##### # ######### # # ##### ### # ### ### # # ### # #####
# #     # # # #   #   # # # #   #   # #   # #   # #   # #   # # # #   #   #   #     # # # #     # # #     #   # #   #   # # #   # #     #
# # # # # # # # # # # # ### # ####### # ##### # # ### # ### # # # # ### # ### # # ### ### # ####### # ### ##### # ### ##### ####### # # #
# # # # # # # # # # # # #   #       # #   #   # #   # #   # # # # #   # #   # # # #               # #   #   # # #   #     #     #   # # #
# # # # # # ####### ##### # # ##### ### ##### # # # ### # # ### # # ### ### # # ##### ############### # ##### # # # # ####### # ### # # #
# # # # # #       # #     # #     #   # #     # # #   # # # #   # # #     # # #     #               # #       # # # #       # #   # # # #
# ### # # # # ### # # ##### # ##### # # ### # # # ##### ### # # # # # # # # # # ### # # ### # ### # # ##### # ### ##### # # # ### # #####
# # # # # # #   # # # #     #     # # # #   # # #     # #   # # # # # # # # # #   # # #   # #   # # #     # #   #     # # # #   # #     #
# # # ##### # ##### # # ### ####### # ### # # # ########### ##### # ### # ### # # # # ### # # # # ### # # # ### # # ### ##### # # # #####
# #       # #     # # # #         # #   # # # #       # #     #   #   # #   # # # # #   # # # # #   # # # #   # # #   #     # # # #     #
### # # ### # ### # ### # # ####### # # # # # # ####### ### ### # ### # # # ### # # # ### # # ####### ### ##### # ####### ####### # ### #
#   # # #   #   # # #   # #       # # # # # # #           #   # #   # # # #   # # # #   # # #       #   #     # #       #     #   #   # #
# # # # ##### ##### # ### # ##### # # # # # # # # # # ##### # # # # # # # ####### # # # # # ### ##### ########### ##### # ### ### # # ###
# # # #     #     # # #   #     # # # # # # # # # # #     # # # # # # # #   #   # # # # # #   #     #           #     # #   #   # # #   #
# # # ### ######### # ### # # # # # # # # # # # ####### ### ### # # ### # ### ### # # # ### # # ### ######### ### # # ##### # # # # # ###
# # #   #         # # #   # # # # # # # # # # #       #   #   # # #   # #       # # # #   # # #   #         # # # # #     # # # # # #   #
# ### # # # ####### # ### # # # ### # # ### # # ### # # # # # # # # ### # # # ######### # # ########### # ##### ### # # ########### #####
# #   # # #       # # #   # # #   # # #   # # #   # # # # # # # # #   # # # #         # # #           # #         # # #           #     #
# # # ### # ##### # # # # ### # ### # # ### # # # # # ### # # # # # ### # # ### ### ####### # # # ### # # ####### # ##### ######### # # #
# # # #   #     # # # # #   # # #   # #   # # # # # #   # # # # # #   # # #   #   #       # # # #   # # #   # # # #     #         # # # #
# # ##### # # # # # ### # # ####### # # # # ### # # # ### ### # # # # ##### ##### ##### ##### # ### ### # # # # ########### ####### # # #
# #   #   # # # # # #   # #       # # # # # #   # # #   #   # # # # #   #       #     #     # #   #   # # #               #       # # # #
# # ##### # # ##### # # # # ### # # ### # ### # # # ### # # # ### # ### # # ### # ########### # ### ### # # ##### ### ### ####### ### ###
# #   #   # #     # # # # #   # # #   # # #   # # #   # # # #   # #   # # #   # #           # #   #   # # #     #   #   #       # #   # #
# # # ### # # # ### ##### # ### ### ##### ### # # ### # # ### ##### # # # # # # ### # # # ##### ### ##### # ############# # ########### #
# # #   # # # #   # #     #   #   # # #   #   # #   # # #   #     # # # # # # #   # # # #     #   #     # #             # #     # # # # #
# # ### # # ### ####### # # ### ##### ##### # # # # ### ##### ### # # ### # # ### ##### # ################# # # # ### # ######### # # # #
# #   # # # # #     #   # #   #       # #   # # # #   #   # #   # # #   # # #   #     # #                 # # # #   # #         #   # # #
# # ##### # # # # # ### # # # ### ##### # # ### ####### # # # ##### # # ### # ### ### # # # ### # ##### ### ##### ##### ######### ### # #
# #     # #   # # # #   # # #   #     #   # #         # #   #     # # # #   #   #   # # # #   # #     #   #     #     #               # #
# # # ### # # ### # # ##### ######### # # # ### ### ### # # ### # # ### ### ### ### ### # # # ### # # ##### ##### ### # # ### # ####### #
# # #   # # #   # # # #             # # # # #     #   # # #   # # #   #   #   #   #   # # # #   # # #   #       #   # # # # # #         #
### # # # # ### ### # ##### # ####### # ##### # ##### # # # # # # # # ##### # # # # # # # ### ### # # ##### # ####### # # # ##### ### ###
#   # # # #   #   # # #     #       # # #   # #     # # # # # # # # #   # # # # # # # # #   #   # # # #   # # #     # # #       #   #   #
### ### # # ### ####### ### # # ### ### # ##### ####### # # # # ######### # ######### # ### # ### # ### ####### ####### # # #############
#     # # #   #     #   #   # #   # #         #       # # # # #           #         # #   # #   # #                 #   # #            x#
#########################################################################################################################################
