#########################################################################################################################################
#o                    #   #   # # #       #     #       #   # # #     #     #               #             #               #     #       #
# ### ### # ########### ### ### # # ####### ##### ####### ### # # ##### ##### ### ### ####### ##### # ##### ##### ### ##### ##### #######
#   #   # #         #   #   # #             # #           #           #   #     #   # #         # # #           #   #                   #
# ### ##### ######### ### ### # ### ### ##### # ########### ####### ### ### ########### ######### ### ### ### ##### ##### ######### # ###
#   #   #         # #     #       #   # #         # #     #       # #     #           # #           #   #   #     #     #         # #   #
# ### ##### # # ### # ##### ##### # # # # ######### # ##### ### ##### ##### ####### ### # ######### ######### # # ################# #####
#   #     # # #                 # # # # #         #       #   # # #               # #             #         # # #   # #           #     #
# # ######### # ##### # ### ### # # ##### ######### ####### ##### # ########### ### # ##### # ############### ### ### # ####### ### # ###
# #         # #     # #   #   # # # # #               # # #     #             #   #       # #               #   #             #   # #   #
# # ####### # # ### # ############### # ### # # ####### # # ##### ##### ############# # # ### ############### ### ### # ########### #####
# #       # # #   # #     #               # # #       #   #           #             # # #   #               #   #   # #           #     #
# # # # ### # # # ### ### # ### ##### ########### ### # ### ####### # # # # ####### # ### ####### ### ##### ######### # # ### ###########
# # # #   # # # # #     #     # #   #       #   #   #             # # # # #       # #   #       #   #     #     #   # # #   #       # # #
# ######### ### # ### ### # ##### ##### ##### ####### # # # ######### # ### ### ##### # # ##### ####### ######### ### # # # ######### # #
#         # # # # #     # #           #   # # #     # # # #         # #   #   #     # # #     #       # #           # # # #           # #
# # ### # # # # ##### # ##### ####### # ### # # ##### ### # # ####################### ####### ####### ### ####### ##################### #
# #   # # #   #   # # #     #       # #             #   # # #                     # #       #       #           #     #           #     #
# # # # ########### # # # # # # ### # # ####### # ####### # ### # ### ##### ####### ### ########### ######### # # ##### ####### ### ### #
# # # #         #     # # # # #   # # #       # #     # # #   # #   #     #           #           #         # # #   #       # # #     # #
# # # # ########### # # # # # ### ##### # # ### ##### # # ### ####### # ############# ######### ######### ####### ### ### ### ### #######
# # # #           # # # # # #   #     # # #   #     #   #   #       # #             # #   #   #   #     #       #       #         # # # #
### # # ### ##### # # # ### # # # # ### # # # # # # ##### # # ### ############# ### # # ### ####### ### ####################### ### # # #
#   # #   #     # # # # #   # # # #   # # # # # # #     # # #   #             #   # # # # # # # #     #           #         # #   #     #
# # # # ### # ### # # # ##### ### ### ##### ### # ### ### # # # # ####### # ####### ### # # # # # ################# ##### ### ##### #####
# # # #   # #   # # # # #       #   #     #   # #   #   # # # # #       # #       # # #                                 #               #
### ### ##### # # # ### ##### # ### # # # # ####### # ### ##### # # # ### # ######### # ####### ####### # ##### # ##### ##### ### ### # #
#     #     # # # #   # #     #   # # # # #       # #   # #   # # # #   # #         #         #       # #     # #     #     #   #   # # #
# # ### ########### ####### # # ##### ### # ############### ##### ### # ### # # # ### ##### ##### # ######### # # # # ### # ### # ### ###
# #   #           #   #     # #     #   # #             #       #   # #   # # # #         #     # #         # # # # #   # #   # #   #   #
# # # # ### # # ### # ####### ### # ####### # ##### ##### ############# # # ### # ### # ##### ########### # ##### # # # # # # # # ### # #
# # # #   # # #   # #   #       # #       # #     #               # #   # #   # #   # #     #           # #     # # # # # # # # #   # # #
# # # # ####### # ### # ##### ################# # # # # # # ####### ####### ### ##### # # # # # ################# # # # # ##### # ##### #
# # # #       # #   # # #                     # # # # # # #           # #     #     # # # # # #                 # # # # # #   # #   # # #
### # # # ##### # ### # ##### ############# ####### ### # # ##### # # # ######### ##### # ### # # # # # ### ### # ######### ##### ### ###
#   # # #     # #   # # #                 #       #   # # #     # # #           #   # # #   # # # # # #   #   # #               #       #
### ### # # ######### ### # # # ######### ##### ### ### ### ### # ### # ####### ##### ### ### ### ### ################# ### # ###########
#     # # #         # #   # # #         #     #   #   #   #   # #   # #       #         #   #   #   #                 #   # #           #
### ##### # ### ##### ##### # # # # ##### ################# # # ##### # # # ### # # ##### # ######### # ################# ######### #####
#       # #   #     # #     # # # #     #               # # # #     # # # #   # # #     # #         # #   # # #   #     #         #     #
### ##### # # # # ### # # # # # # # ############# ####### # # # ### # ### # ### # ### ##### ############### # # ### ######### # ### ### #
#       # # # # #   # # # # # # # # #   #       #     #   # # #   # #   # #   # #   #     #               #                 # #   #   # #
### ####### # ### # # # ### ### # # # ### ####### ##### ### ### # ### # # # # ### # ########### ### ####### ####### # ### # ### ####### #
#         # #   # # # # #   #   # #             #         #   # #   # # # # #   # #           #   #               # #   # #   #       # #
### # ##### ##### ##### # ### # ### # ### ########### # ### ### # ### ### ### # ### ### ### # # # ####### ######### ### ### # ### # # # #
#   #   #       #     # # #   # #   #   #           # # # # # # #   #   #   # #   #   #   # # # #       #         #   #   # #   # # # # #
### # ####### ##### ##### # # ##### # # ### # # ##### # # ### ######### # ### # # # ### ### # # # # ### # ### ##### # # # ### ### ### ###
#   #       #     #   # # # #   #   # #   # # #     # #         # # # # #   # # # #   #   # # # # #   # #   #     # # # #   #   #   #   #
# # # ####### ######### ### # ### # # # ### ### ########### ##### # # ##### # # # ### # ### ##### ### ############# ### # ### ### ### # #
# # #       #   #     #     #   # # # #   #   #           #               # # # #   # #   #     #   #             #   # #   #   # #   # #
# # # # # # # ### ######### # ##### ### ### # # # # # ############# ######### ### # # # ### # # ##### # # # # ########### ####### ### ###
# # # # # # # # # #     #   #   # # #     # # # # # #   #         #         #   # # # #   # # #     # # # # #           #       #   # # #
# # # ### ### # # # ##### # # ### ##### ### # ########### ######### ################# # ### ### ##### ##### ### ######### ############# #
# # #   # #             # # # # # #       # #                     #         #       # #   #   #     #     #   #         #               #
# # # ####### ### # # # ### # # # ##### ##### # ### ### ##################### ##### ### # # ### # ### ####### ############# # # ##### ###
# # #     #     # # # #   # #     #         # #   #   #         #     # #         #   # # #   # # #         #             # # #     #   #
### # # ### # # # # # ####### ### ##### # ### # # # # ####### ### ##### # ##### # ### # # # # # ##### # # ############################# #
#   # #   # # # # # #   #       # #     # #   # # # # #   # #                 # #   # # # # # #   #   # #                           # # #
# # # # # # # ##### ### ### # # ### ### # ### ##### # # ### ############### # ### ####### ### # ### # ### # ########### ####### ##### ###
# # # # # # #     #   # #   # #   # #   #   #     # #                     # # # #       #   # #   # #   # #           #       #         #
# # # # # ### # # # # ### # # # # ##### ##### # ##### # ######### ##### # ##### ######### # ############# # ####### ### ####### # #######
# # # # # #   # # # # #   # # # # #         # #   #   #       # #     # #               # #       # # #   #       #   #     #   #       #
# # ##### ### ### ##### # # ##### ##### ####### ##### # # ##### ####### ### ### ############# ##### # ### # # # # ### ######### ### #####
# #     #   # # #     # # #     # #           #   #   # #             #   #   #   #         #       #   # # # # #   #         #   #     #
# # ##### # # # # # # # # # # # # ##### ####### # ### # ### # ######### # ### ### # ##### ### ####### ######### # # # ### ##### # # ### #
# #     # # #   # # # # # # # # # #           # #   # #   # #         # #   #   #       #   #             #   # # # #   #     # # #   # #
# # # # ### # # # ##### # # # # ### ### # # # ####### # # # # # # ####### ### # # ### # ######### # ### ### ####### # # # # # ###########
# # # #   # # # #     # # # # # #   #   # # #     #   # # # # # #       #   # # #   # #         # #   #           # # # # # #       # # #
### ### # # # ##### # ##### # # # # ### # # # # # # # ####### # # # # ##### # # # # ### # ### ##### ### ######### ######### ####### # # #
#     # # # #     # #   #   # # # # #   # # # # # # #     #   # # # #     # # # # #   # #   #     #   #         #         #       #     #
# # # ### ### # # # ##### # # ### # # # ##### ### # # # ### # ####### ### ### ##### # # # # # # # # # # # ######### ### # ########### # #
# # #   # #   # # #     # # # #   # # #     #   # # # #   # #       #   #   #     # # # # # # # # # # # #         #   # #   #   #   # # #
# # # ### # # # # ####### # # # # ### # # # # # ##### # ### # # # ### ### # ### # # ### # # # ### # # ### # ####### # ### ### ### ### # #
# # #   # # # # #       # # # # # #   # # # # #     # #   # # # # # #   # #   # # #   # # # #   # # # # # #       # #   #           # # #
# # # # ### # # # # # # # # ##### ### # # # # ####### ##### # # ### # ##### ####### ### ######### # ### # # # ##### ######### # # # #####
# # # #   # # # # # # # # # #     #   # # # #     #       # # #     #     #       #   #       # # #     # # #     #         # # # #     #
# # # # # ### ### # ### ### # # # ### # ### # # ### # # ### # # ####### # ### ### # ####### ### ### # # # # # ########### ### ### # # ###
# # # # # #     # # # #   # # # #   # #   # # # #   # #   # # #     # # #   #   # #       #       # # # # # #           #   # #   # # # #
### ### # ### ### # # # ### ##### # # # ##### ####### ### # # ##### # ### # # # ########### ######### ### ### # ### ############# # # # #
#   #   #   # #   #   #   #   #   # # #     #   # #     # # #     #     # # # #       #   #         #   # #   #   #       #     # # #   #
# # # # ##### ### ### ##### # # # ### # # ####### # # # # ### # # # ### ### # ######### ########### # # # # # ### ### # # # ####### # ###
# # # #   #   #     #     # # # # #   # #         # # # #   # # # #   # # # #                     # # # # # #   #   # # #         # #   #
### # # # ##### # # ####### ### # # # # ####### # # # ####### # ### ##### ########### # # ####### ### ####### # ### ### ########### # ###
#   # # #   #   # #       #   # # # # #       # # # #       # #   #                 # # #       #   #       # #   #   #           # #   #
# # # # # # # ### ### # ### ##### # # # # # # ##### # # # ### # # # # # ######### ### # ### # ### ####### # ### # # # # # # ### # ##### #
# # # # # # # #     # #   #     # # # # # # #     # # # #   # # # # # #         #   # #   # #   #       # #   # # # # # # #   # #     # #
### ##### ### # # # # # ### # ##### ##### # # ####### # # ##### ### # # ####### # # # ### # # # # ##### # ### # # # ### ### # # ### ### #
# #     # #   # # # # #   # #     # #     # #   #     # #   # #   # # #       # # # #   # # # # #     # #   # # # #   #   # # #   #   # #
# # # ### # # ### # # # # # ####### # # # # # # ### # # # ### # ### # # # ### ### ### ### ##### # ### ### # ### # # # # # ### # # ##### #
#   #   # # # #   # # # # #       # # # # # # #   # # # #     #   # # # #   #   #   #   #     # #   #   # #   # # # # # #   # # #     # #
### # # ### # # # # # # # # # # # # ### # # # # ### # ### # ####### ##### ####### # # ##### ##### # ####### # ##### ### # ##### # # #####
#   # #   # # # # # # # # # # # # #   # # # # # #   #   # #       #     #     # # # #     #     # #       # #     #   # #     # # #     #
# # # ##### # ### # # # # # ### ### ### # # # ### # # # # # ####### # ##### ### ##### # ##### # ### ####### ####### # # # # ### # # # # #
# # #     # #   # # # # # #   #   # #   # # #   # # # # # #       # #     #       # # #     # #   #       #       # # # # #   # # # # # #
# # ### # # # # # ### # ### ### ### # # ### # # ##### ### # # ####### # ########### ##### ####### # ####### ##### # # # ### # # # # # # #
# #   # # # # # # #   # #     #   # # #   # # # #       # # #       # #           #     #       # #       #     # # # # # # # # # # # # #
### ######### ### ### ##### # ##### # # ### ######### # # # # # # ########### ### # ### # ######### ### ### # ##### ##### ####### ### # #
#           # #   #   #     #     # # #   #   # #     # # # # # #   #       #   #     # #         #   #   # #     #         #   #   # # #
# # # # # # ### # ### # ### ########### ####### # # # ### # # # # ### ##### ### # # # ### # ### # # # ### ### # ### # ### # # ######### #
# # # # # # #   # #   # #             #         # # # #   # # # #         #   # # # #   # #   # # # #   # #   #   # #   # #           # #
# # # # # ### # # # ### # # ##### # ### # # ##### # # ### # # # # # # ####### ### # # ### ######### # ####### # # # # ### ########### ###
# # # # # #   # # # #   # #     # # #   # #     # # # #   # # # # # # #     #   # # #   #         # #       # # # # #   #           # # #
# # # # # # ########### ### # # ### ### # # ##### # # # # # # # # # # # ### ##### ##### # ##### ### ####### # # # # # ### # ### # ##### #
# # # # # # #           #   # #   # #   # #     # # # # # # # # # # #     #   # #     # #     #   #       # # # # # #   # #   # #       #
# # # # ##### ### # # # # ### # ### # # # ### # # # # # ### # ##### # ######### # # ##### ### ######### # ##### ##### # # # # # ### # ###
# # # # #     #   # # # # #   #   # # # #   # # # # # # #   #     # #       #   # #     #   #         # #     #     # # # # # #   # #   #
### # ##### # # ### # # # ### # ##### # # ### # ### # # # # # ##### # # # ### ### ### # # # ### # ### # # ##### ### # # ### ### # # # # #
#   # #     # # #   # # # #   #     # # #   # #   # # # # # #     # # # #       #   # # # #   # #   # # #     #   # # # #     # # # # # #
############# ##### ### ### # # # # # ### ##### ### ####### # # # # # # # ####### ### ### # # ### # # # ##### # ####### ### ### # # #####
#             #       #   # # # # # # #       # #         # # # # # # # #       #   #   # # #   # # # #     # #       # #     # # #     #
# ######### ##### # # # # # # # # # # # # # # # ### ### # # # # ### # # # # ######### ### # # # # ### ##### # # ######### # ### ### # # #
# #   #     # # # # # # # # # # # # # # # # # # #     # # # # #   # # # # #         #   # # # # #   #     # # #         # #   #   # # # #
# ### # ##### # # # ### ####### # # ### # # # # # # ### # # # # # # # ### # # ####### # # ####### # # # # ### # # ### ##### ### # # ### #
# #   # #         # #       #   # #   # # # # # # #   # # # # # # # #   # # #       # # #       # # # # #   # # #   #     #   # # #   # #
##### ##### # # # ### # # ### # ##### # # # # # ### ####### ### ### # # ### # # # # # # # # # ####### ### # ### # # ##### # ### ### # ###
#           # # # #   # #   # #     # # # # # # #       #   #     # # #   # # # # # # # # # #     # #   # #   # # #     # #   # #   #   #
# # # # # ### # # # # # ### ### # # ####### # # ### # ##### # # ### # ### ### ####### ### ### # ### ######### ### # ####### ####### #####
# # # # # #   # # # # #   # #   # #       # # # #   #     # # #   # #   #   #       #   #   # # # #         #   # #       #     #       #
##### ######### # # # # # # ### ########### # # ### # ##### ### # # ### # # ##### ### # # # # ### # ##### ### # # # # ##### # # ### # ###
# #   #         # # # # # #   #           # # # #   #     #   # # #   # # #     #   # # # # #           #   # # # # #     # # # #   #   #
# ##### ##### # # # ### # # # # # # ### ######### # # # # # ### # # # ### # ### ########### # # ##### # ##### ### # # # # # # # ### # # #
#       #     # # # #   # # # # # #   #         # # # # # # #   # # #   # #   #           # # #     # # #   #   # # # # # # # #   # # # #
### ##### ### # # # # # # # # # # # ### ######### # ### # # ### # # ### # # # # # ##### ### # # # ### ### ####### # # ####### # # ##### #
#   #     #   # # # # # # # # # # #   #         # #   # # # #   # #   # # # # # #     #   # # # #   #   #       # # #       # # #   #   #
# # # ### ### # ### ### ### # # # # # # # ### ### # # # # # # # # # # ### ### # ######### ### # # ### ### ######### # # ### # # # ### # #
# # # #   #   # #   # #   # # # # # # # #   #   # # # # # # # # # # #   #   # #         #   # # #   #             # # #   # # # #   # # #
##### ### # # ### # # # ### # ### # ####### # # ### # # # # # # # ### ### # # # # ### ### ### # # ############### # # # ### # ### ### # #
#   # # # # #   # # #     # #   # #       # # # #   # # # # # # #   #   # # # # #   #   #   # # #               # # # #   # #   # # # # #
### ### ### # ### # ### # ### ### # # ##### # ### # ### ### # # # ### # # # # # # # ### ### ##### ##### # # ############### ### ### #####
#           #   # # #   # #     # # #     # #   # #   #   # # # #   # # # # # # # #   #   #   #       # # #           #   #   #       # #
######### # # # # ### # ##### # ### # # ##### ##### # # ### # # # ### # # # ### # # ### # ### ### # ### ### ########### ######### ### # #
# #       # # # # #   #   #   #   # # #   #       # # #   # # # #   # # # #   # # # # # #   # #   # # # # #                     #   #   #
# ### ### # # ##### # # # # # # ### # ### ### ##### ####### # ### # # ### # # # ### # # ##### ##### # ### ####### ########### ### #######
#     #   # #   #   # # # # # #   # #   #   #   #         # #   # # #   # # # #   # # #     #     #             #         # #   #     # #
# ######### # ##### ### ####### ### ### ##### ### # ### ##### ### # # ##### ######### # ########### ####### # ############# ########### #
# #         # #     #       #   #     #     #   # #   #     #   # # #     #           #           #       # #                          x#
#########################################################################################################################################
