#########################################################################################################################################
#o                                                  #   #       # #   # #                         #     #                       #       #
# # # # ######### ### ####### # # ######### ######### ### ####### # ### # ##### # ### ######### # # ### # ################# ##### ##### #
# # # #         #   #       # # #         #     #               #     # #     # #   # #       # #     #                   #   #       # #
# ### ####### # ##### # # # ### ############### # ####### ####### ##### # ##### ####### ############# ####### ### # # # ####### ### #####
#   #       # #     # # # # # #     #         #         #     # # #           #             # #     #       #   # # # #           #     #
# # # ####### ########### ### ####### ########### ######### ### # # ##### ##### ######### ### # ### # ######### # ### ##### ### # # # # #
# # #       #         # #     #     # #     #   #       # # #     #     #   # #         #         # #       # # #   #     #   # # # # # #
# ### ##### # # ####### ####### ##### # ##### ######### # ### ##### ######### ##### ### ######### ####### # # ####### # ######### # ### #
#   #     # # #               # # # # #   #           # # # #             #       #   #         #       # #         # # #       # #   # #
# ### # ##### ######### ####### # # # # ### ### ### # ### # # ######### # # ### # # # ### ##### ##### # # ############### ##### #########
#   # #     #         #   #                   #   # # #               # #     # # # #   #     #     # # #         #   #   #   #       # #
# ### # # ##### # ####### # ####### ############### # # ##### # ####### # ########### ### # ### ### # ############# ### ### ####### ### #
# #   # #     # #       #     #   #               # # #     # #       # #       #   #   # #   #   # #                         #   #   # #
##### # # # ##### # ##### ### # ####### ### ########### ############# ### ####### ### ####### # ######### ### ############# # # ##### # #
#     # # #     # #     #   #         #   #                         #   #           #       # #         #   #             # #       #   #
##### ### # ####### ##### ### # # # # ##### # ### # ################### # # # ### ### # ########### ############### # ####### ###########
#       # #     #       #   # # # # #     # #   # #                   # # # #   #   # #           #               # # #     #           #
# # # ### # ### ### # ### ### # ### ### # ####### # ##### ######### ############### # # # # # # # # ################### ####### #########
# # #   # #   # #   #   #   # #   #   # #     # # #     #         #               # # # # # # # # #             #             #         #
# # # # ### ### # # # ### ########### ### # # # ####### # ### # # # ##### ### # ##### # # # # # ############### # ##### ### # # #########
# # # #   #   # # # # # #           #   # # #         # #   # # # #     #   # #     # # # # # #               #       #   # # #         #
# # # ##### # ####### # # # ##### ####### # # # ##### # # ##### # ##### ### # # # ### # ##### # ##### ####### # ####### # # ########### #
# # #   # # #       #   # #     #       # # # #     # # #     # #     #   # # # #   # #     # #     #       # #       # # #           # #
# ### # # ### # # ### # # # # # # # # ####### ### ### # # ### # # ### ### # # ##### ### # # # # ### # # # ######### ####### # ####### # #
#   # #     # # # #   # # # # # # # #       #   #   # # #   # # #   #   # # #     #   # # # # #   # # # #         #       # #       # # #
# # # ### # # # # ### ### # # # ### ### # # # ####### ### # ##### ### ### ####### ##### # ##### ##### # # # ### ### # ### # # # ### #####
# # #   # # # # #   #   # # # #   #   # # # #       #   # #     #   #   #       #     # #     #     # # # #   #   # #   # # # #   #     #
# # # ### # # ### ### # ### # # ### # ################### ####### # # ### # # ########### ### # ##### # # # ######### ##### ### ####### #
# # #   # # #   #   # #   # # #   # #           #       #       # # #   # # #           #   # #     # # # #   #     #     #   #       # #
# # # # ### # ####### ####### # # # ##### ##### # ######### ##### # # ### # ####### ##### ### # ### # # # # # # ########### # ### # ### #
# # # #   # #       #       # # # #     #     #           #     # # #   # #       #     #   # #   # # # # # #             # #   # #   # #
# # # ####### ### ### ### # # # # # # # ### ############# ##### ### ### ### # # # ####### ### # ### # ### # # ######### # ### # # # # ###
# # #       #   #   #   # # # # # # # #   #             #     # # #   #   # # # #       # #   #   # #   # # #         # #   # # # # #   #
# # # ##### # # # # # # # # # # ### # # ##### ### # ############# ### # # # ##### ### ### # # # ################### # # ### # # ### #####
# # #     # # # # # # # # # # #   # # #     #   # #                 # # # #     #   #   # # # #       #           # # #   # # # #       #
# # # # ##### ### # # ######### # # # # # # # # # # # # # # # ##### ### ### # ### ### ####### # ### ### ######### # # # ########### #####
# # # #   #     # # #         # # # # # # # # # # # # # # # #     #   #   # #   #   #       # #   #             # # # #         #       #
### # # ### # # ##### # # ### # # ##### # ### # # ######### ### # # ### ##### ########### ### # ### ### ### # ####### # # # ##### # #####
#   # #   # # #   #   # #   # # #     # # # # # #         #   # # #   #     #           #   # #   #   #   # #       # # # #     # #     #
# # # # # ### ### # # # # ### # # # ### # # # ########### # # # ### ### # ### ### ### ####### # # # ####### ### ### # # # # # ### # # ###
# # # # #   #   # # # # #   # # # #   # #   #           # # # #   #   # # #     #   #       # # # #       #   # # # # # # # #   # # #   #
# # # # # ### # # # ### # ### # # ### # # # ##### # ##### ####### # # # ### # # # # ### ######### # # ### ####### ##### ### ### ### # ###
# # # # #   # # # # #   # #   # #   # # # #     # #     #       # # # #   # # # # #   #         # # #   #             #   #   # #   # # #
### ### # ### # # # # # ##### # # # ### # # ### ##### # # ######### ### # # # # # # # ####### # # # ############### # # ############### #
#     # #   # # # # # #   #   # # #   # # #   #     # # #         #   # # # # # # # # #     # # # #               # # #                 #
### # # # # ##### ### # ### # ### ### ### # ########### # # # ############### # ####### ######### # # ### # ### # # ########### #########
#   # # # #     #   # #   # #   #   # #   #           # # # #           # # # # #               # # #   # #   # # #   # #     #         #
# # # # # ### ### # # # # ####### # ### # ### ### ### # # ### ##### ##### # ##### ########### ####### ### # ### ##### # # ### ### #######
# # # # #   #   # # # # #       # #   # #   #   #   # # # #       #   #                     #       #   # #   #     #       #   #       #
# # # ##### ### # # # # # # # ### # ### # # # # # ##### # # # # # ##### ### # ########### # # ### # ##### ############# ############# ###
# # #     #   # # # # # # # #   # #   # # # # # #     # # # # # #         # #           # # #   # #     #             #             #   #
# # # # # ##### ##### # # ### # ### ### # ### ### ####### # # # # ################### ### ####### # # # ######### ### ########### # #####
# # # # #     #     # # #   # #   #   # #   #   #     #   # # # #                   #   #       # # # #         #   #           # #     #
# # # # # # # ### ##### # # # ##### ### # # # ### ### ### ### # ### # ### ### # # # # ### # # ############### ### # # # ### ### # # #####
# # # # # # #   #     # # # #     #   # # # #   #   # #   #   #   # #   #   # # # # #   # # #               #   # # # #   #   # # #     #
### # ### # ####### ####### # # ### ### ### ### # # ##### # # # ### # # ### # # # # ##### ### ####### ### # # ##### # # # # ### # # # # #
#   # #   #       #     # # # # # #   #   #   # # #     # # # #   # # #   # # # # #     #   #       #   # # #     # # # # #   # # # # # #
### # # ### # # ######### # # # # # # # # # # # ### # ### # # # ####### # ### # ######### # # # # ##### ### ####### ### ######### # ### #
#   # # #   # #           # # #   # # # # # # #   # #   # # # #       # #   # #         # # # # #     #   #       #   #         # # # # #
# # # ### # # ### # # # ### # ##### ####### # ##### ##### # ### # # # # # ##### # # ##### ### ########### ############# # # # ##### # # #
# # #   # # #   # # # #   # #     #       # #     #     # # #   # # # # #     # # #     #   #           #       #     # # # #     #   # #
# # # ### # # ##### # # # # # ######### ### # # ### # ####### # # # # # ####### # ### # # ##### ##### # # ####### ##### # # ### ### # # #
# # #   # # #     # # # # # #         #   # # #   # #       # # # # # #       # #   # # #     #     # # #             # # #   #   # # # #
##### ### ### # ### ### ##### ### # # # # # ### ### # # # ##### # # # ### # # ### ##### ### ### # # # ####### ### ### # ### ### ### # # #
#   # #     # #   #   #     #   # # # # # #   # #   # # #   # # # # #   # # #   #     #   #   # # # #       #   #   # # # #   #   # # # #
### # ### # # # # # # # # # # # # # # # # # ### # # ####### # ### ### # # # ##### ####### # ### ##### # ### # # ######### ####### ##### #
#       # # # # # # # # # # # # # # # # # #   # # # #     #     #   # # # #     #       # #   #     # #   # # #                 #   # # #
# ### # # # # ### # # # # ##### # ##### ### # ##### # ### # ### # # # # # # ### # # # ### ##### # ### # ### ######### ####### # ##### ###
# #   # # # #   # # # # #     # #     #   # #   #       # #   # # # # # # #   # # # #   #     # #   # # #           #       # #         #
# # # # # # # # # # # # # # # # ### # # # # ### ### ############# # # ### # # # # ######### ########### ### ############# # # ####### # #
# # # # # # # # # # # # # # # #   # # # # #   # #               # # #   # # # # #         #         # #   #             # # #       # # #
# # # # ### # # # ### # # # # # # # # ##### ##### # # ### ########### # # # # # # ### # # # ### ##### ########### # ### # ####### # ### #
# # # #   # # # #   # # # # # # # # #     #   # # # #   #           # # # # # # #   # # # #   #         #       # #   # #       # #   # #
### # ### # # # ### ### # # ### ### ### ### ### # # # ### # ### ### # # ### ##### # # # # # ### ######### ### ##### # ####### # # # # # #
#   #   # # # #   # #   # # #     #   # #       # # #   # #   #   # # #   #     # # # # # #   #             #     # #       # # # # # # #
# # # ### ### # ### ### # # ##### # # # ### ####### # ### # ##### ##### # # ### # # # ### # # ### # # ######### # # ####### # ####### # #
# # #   #   # #   #   # # #     # # # #   #       # #   # #     #     # # #   # # # #   # # #   # # #         # # #       # #       # # #
# # # ### ##### # ### # # # # # # # # ##### # # # # # # # # # # # # ##### # # ### ##### # ### ### ### # # ### # # ##### # # ######### # #
# # #   #     # #   # # # # # # # # #   #   # # # # # # # # # # # #   # # # #   #   # # #   #   #   # # #   # # #     # # #         # # #
### # # # # # # # ##### ### # # ########### # # # # # ### # ### ### ### ### # # ##### ### # ### # # # # ##### # # ####### # # # ### ### #
#   # # # # # # #   # #   # # #           # # # # # #   # #   #   #       # # #         # #   # # # # #     # # #       # # # #   #   # #
### ### # # ### # # # ######### ##### # # # # # ### ##### ##### ### ##### # # ##### ### ### ### # # # # # ####### # ####### ### ####### #
#     # # # #   # #           #     # # # # # #   #     #     #   #     # # #     #   #   #   # # # # # #       # #   # # #   #       # #
# # # ### ##### ### # # # ##### # # # ##### # # # # # ### ### # # # # ##### # # ### ####### ### ######### # ########### # # # # # # #####
# # #   #     #   # # # #     # # # #     # # # # # #   #   # # # # # #     # #   #       #   #         # #               # # # # #     #
# # ####### ### # # # ### # # # # # ### # # # # # # # ### ### # ### # ####### # # # # # # # ############# # # # # # ############### #####
# #   #   #   # # # #   # # # # # #   # # # # # # # #   #   # #   # #       # # # # # # # #             # # # # # #       #       #     #
### # # ### # # # ### # ### # ### # # # # # # # # ### ### # # # ### ####### # # ### # # # # ################# # # # ### # # ####### # ###
#   #     # # # #   # #   # #   # # # # # # # # #   #   # # # #   #       # # #   # # # # #                 # # # #   # #         # #   #
# # # # ######### # ### ### ##### # # ### ### # # # # # # # # # ##### # # # # # ##### # ### # ### # # ##### # # # # # ### ##### # # # ###
# # # #       #   # # # #       # # # # #   # # # # # # # # # #     # # # # # #     # #   # #   # # #     # # # # # #   #     # # # # # #
# ### # # ### # # # # ##### # # # ##### # ### # # # # # ##### # # ### # ##### ### # # ### # # ### # # ### ### # # # ##### # # ### # # # #
# #   # #   # # # #       # # # #       #   # # # # # #     # # #   # #     #   # # #   # # #   # # #   #   # # # #     # # #   # # #   #
# # # # # # ##### # ### ### ##### ####### ### # # # ### # # # # # ##### ##### # # # # # # # # # # ### ########### # ##### # # # # ### ###
# # # # # #     # #   #   #     #       # #   # # #   # # # # # #     #     # # # # # # # # # # # # # #         # #   # # # # # # #     #
# ### # ### ##### # # # # # ################# ##### ### # # # # # ### ####### # # ####### # # ### # # # ##### ### # # # ### ### ### # # #
# #   # # #   #   # # # # #       #         #   #   # # # # # # #   #       # # #       # # #   #   #       #   # # #     #   # # # # # #
# # # ### # ##### # # # # # # # ### ### ##### ##### # # ##### ### # ######### # # # # ##### # ### # ### # ### # # ##### ### ##### # # # #
# # #     #     # # # # # # # #       #     #   #     #     # #   #         # # # # #   #   #   # #   # #   # # #     #   #   # # # # # #
# # # # # # # ### ### # # # ##### # ### # ### # ### # ####### # # # ### # ### ### # ##### # # # # # ##### ### ### # # # ####### # ##### #
# # # # # # #   #   # # # #     # #   # #   # # #   #       # # # #   # # # #   # #     # # # # # #     #   #   # # # #   #         #   #
# # # # ##### ### # # # # ######### # # ### # # ### ##### ### ### # # ### # # # # ### # # ### # ### # ##### ##### ##### # # ### #########
# # # #     #   # # # # #         # # #   # # # #       # # # #   # #   #   # # #   # # #   # #   # #     #     #     # #     #         #
# # # # # # ##### # ### # ##### ### # # # # ####### ### # # ##### # # # ######### # ### # # ### ##### # # ####### ####### ##### ##### # #
# # # # # #   # # #   # #     #   # # # # #     #     # #   #   # # # #         # #   # # #   #     # # #       #       #     #     # # #
### # ### # # # # # # # # # # ######### # ####### # # # ##### ### # # # ####################### # # ### # # # # ####################### #
# # #   # # #   # # # # # # #       #   #       # # # #         # # # #                       # # #   # # # # #     #   #     #       # #
# # ##### # # ##### # # # ### ### # ### # # ### # # # # # ### # ### ### # # # # # ##### ##### # # # ### # ### ####### ### ##### ##### ###
#       # # #     # # # #   #   # #   # # #   # # # # # #   # #   #   # # # # # #     #     # # # # #   #   #                       #   #
### ### # # # ### ##### # # # ### # # # # # ### # # ### # # # ##### # ##### # ### # # # # ##### # ##### ### ##### ### ### # ######### ###
#     # # # #   # #     # # #   # # # # # #   # # # #   # # #   #   #     # #   # # # # #   #   #   #     #     #   #   # #         #   #
### # # ### # # ##### ### # # # ### # # # # # ### # # # ### ### ### # # # ### ##### ### ######### # # # # # ##### # # ########### # #####
#   # #   # # #     # #   # # #   # # # # # #   # # # # #     # #   # # #   #     #   #         # # # # # #     # # #           # #     #
# # ### ### # # ### # # # # # ######### ### ### ### ### ### # # # # # # # ##### ### ### # ####### # ### ### ### # ### ##### # # # #######
# #   #   # # #   # # # # # #   #     # #     #   #   #   # # # # # # # #     #   #   # #       # # #     #   # #   #     # # # #       #
# # # # # # # # # # # # # ### ### ####### # ######### ##### # # # # # # # ##### # # ### ##### ######### # # # ### ### # ##### # # # # ###
# # # # # # # # # # # # # #             # #         #     # # # # # # # #     # # #   #     #         # # # #   #   # #     # # # # # # #
# # # # # ### # # # ### # # # ##### ### # # ### # # # ##### # # ### ### # ### ### ######### # # # ##### ### # # # # ####### ### ####### #
# # # # #   # # # #   # # # #     #   # # #   # # # #   #   # #   #   # #   #   #         # # # #   #     # # # # #       #   #       # #
# # # # # # # ### # ### ### # ##### ####### # # # ######### ##### # # # # # # # # # ##### ### # # # ### # ### ### # # ######### ##### # #
# # # # # # #   # #   # #   #     # #     # # # #       #       # # # # # # # # # #     #   # # # #   # #   #   # # #         #     #   #
### ##### # # # # # ######### # ##### ####### ### # ##### # # # # ##### # ### ### # ### ### ### ##### # # # ### # ### # ####### # # # # #
#       # # # # # #   #       #             #   # #     # # # # #   #   #   #   # #   #   # #       # # # #   # #   # #       # # # # # #
### ### ### # # # ### # ### # ####### ### ### # # # ### ### # ### ### # ##### ### # # ### ### # ### ### # # # ### # ### ### ##### ### ###
#     #   # # # #   # # #   #       #   #   # # # #   #   # #   #   # #     # #   # #   #   # #   #   # # # # #   #   #   #   # #   #   #
# # # ##### # # # ##### ### # ### # # # # ##### # ### # ### # ### ##### ### ### # ############# ### # # # # # ### # ### ### # # # ### ###
# # #   #   # # #     # #   #   # # # # #     # #   # #   # #   #     #   #   # #             #   # # # # # #   # #   #   # # # #   #   #
# # # # ### # # ### ### ### # # # ### ### # # # # # ####### # # # ##### # # ##### # # ##### # # ##### ### # ### # # ### ####### ### # # #
# # # #   # # #   #   # #   # # #   #   # # # # # #       # # # #   #   # #     # # #     # # #     #   # #   # # #   # #         # # # #
# # # # ##### # # ### ### # # # # # # ### # # # # ########### ### # ### # ####### # # # # ### # ########### # ##### # ### ############# #
# # # #     # # #   # #   # # # # # #   # # # # #           #   # # #   #   #   # # # # #   # #     #     # #     # #                 # #
# # # # ##### ### # # ### # # # # # # ##### ### # ############# ### # # # ### ### # # ### ########### ######### ### # # ##### # # # # ###
# # # #     #   # # #   # # # # # # #     # #   # #           #   # # # #       # # #   #       #             #   # # #     # # # # #   #
# # ### # ####### # # ### ### ##### ####### # # # # ########### ####### # # # ####### ########### ############# ####### # # ####### # # #
# # #   #       # # #   # #       #       # # # #             #     #   # # #       #                         #       # # #       # # #x#
#########################################################################################################################################
