#########################################################################################################################################
#o                    # #                   #                 #                         #   #       #   #   # # #   # #   #     # # # # #
# # ### # ############# # ######### ######### ####### ######### ############# ########### ### ####### ### ### # # ### # ### ##### # # # #
# #   # #     # # #   # #         #                 # # #     #       #     #                     #   # # # #   #   # # #           # # #
# # # # # # ### # # ### # ########### ################# # ##### ### ### ### # # ############### ### ### # # # ### ### # # ########### # #
# # # # # #     #                   #   #   #           #         #       # # #               #                   #   # # #       # # # #
### ##### ####### ######### # ########### ### ### ##### # ############################### ##### ####### ########### ### # # ##### # # # #
#       #                 # #     #             #     #         #       #     #         #     #   # # # # #           #         # # #   #
# # ####### # ####### ### ######### ######### # ### # ########### ####### ##### ##### ######### ### # ### # ########### ########### # ###
# #       # #       #   #                   # #   # # #   #           #   #         #       # # #   #         # # #   #     #   # # # # #
### ### # ################### ################# # # ### ### ######### # ### ########### # # # ### ### ### ### # # # ### ##### ### # # # #
# #   # #                   #                 # # #                 #                 # # # # #   #     #   #   #           #       #   #
# # ### # # # # # # ####### ####################### # # # ### ### # ##### ######### ######### # ### ####### ##### ##### # ### ####### ###
#     # # # # # # #       #                       # # # #   #   # #     #       # # # # # #       #       #           # #               #
# # ### ### # # # # ### # ### # # ########### ############### ####### # # # ##### ### # # # ####### ##### # ####### # # ### # # # ### # #
# #   #   # # # # #   # #   # # #           #               #       # # # #                             # #       # # #   # # # #   # # #
# # # # ### ##### # ### # ### ### ##### # ### ### ############### ### ######### ####### # ####### # # # ##### # ### ### ### ### # ### ###
# # # #   #     # #   # #   # # #     # #   # # #               #   #   # #   # #     # #       # # # #     # #   #   #   #   # #   #   #
# # # # # # ####### ### # # # # # ### # # # # # ### # ### # # ##### ##### # ##### ### ##### # ### # ####### # # # # ####### # ##### # ###
# # # # # #       #   # # # #   #   # # # # #     # #   # # #     #         #       # # # # #   # #       # # # # #       # #     # # # #
### # # ### # ### # # # # ### # # # # # # ### # # ####### ################### ######### # ### ############# ### ##### # ### ### ### ### #
#   # #   # #   # # # # #   # # # # # # # #   # # #     #               #                   #             # # #     # #   #   #   #     #
##### # ##### ### # ##### ######### # # # ### # ### ################# ### ############# ### ################# # # ####### ###############
#     #   #     # #     #         # # # #   # #             # # # # #                 #   #                   # #       #     #         #
# ### # # # # ##### # # ##### ####### ### # ### # # # ####### # # # ######### # ######### # ##### ### ######################### ##### ###
# #   # # # #     # # #     #     # #   # #   # # # #                       # #         # #     #   #             #                 #   #
# ### # ### # ##### ####### # ### # # # # ### # # # # # # ### # ##### ##### ### # # ####### # # ### ##### ### ##### ### # # # ####### # #
# #   #   # #     #       # #   #   # # #   # # # # # # #   # #     #     #   # # #       # # #   #     #   #         # # # #       # # #
# # # ### # # # ################### # ### ### # # ### # # ####### # ### # # # ### ##### ### ######### # ######### # ######### ###########
# # #   # # # #                   # #   #   # # #   # # #       # #   # # # #   #     #   #         # #         # #         #           #
# # # ######### ####### # # # # # ######### # ### # # # # # # # ### # # # ################# ########### # # ##### # ### # ####### # #####
# # #   #             # # # # # #         # #   # # # # # # # #   # # # #         #       #           # # #     # #   # #       # #     #
# # # ### # # # # ### ################### # # # # ### ### ### # # # # # ##### # ### ########### ### ### ### # ### # # ##### # # ##### # #
# # #   # # # # #   #       #           # # # # #   #   #   # # # # # #     # #               #   #   #   # #   # # #     # # #     # # #
# # # ### # # ### ### # # ### ####### ### ##### # # ##### # # # ### ### # # ######### ##### ############# # # ### ### # # ### # # ### # #
# # #   # # #   #   # # #   #       #   #     # # #     # # # #   #   # # #         #     #             # # #   #   # # #   # # #   # # #
### ### # # # # # ### ### ### ####### ####### ##### ### # ### ### # # ##### ### ####### ####### ##################### # ### ### # ### # #
#     # # # # # #   #   #           #       #     #   # #   #   # # #     #   #       #       #               #     # # # #   # # #   # #
### # # ##### # # # ##### # ######### ### ### # ####### # # ### # # ### ### # # # # ##### ##################### ### ##### ### ### ### # #
#   # # #     # # #     # #         #   #   # #       # # #   # # #   #   # # # # #     #                   #     #         #   #   # # #
### ####### # ##### ### # # ### # ########### # # # # # ####### ### # # ### # ### ### # # # ############### # ####### ### # ### # # # # #
#     # #   #     #   # # #   # #           # # # # # #       # #   # #   # #   #   # # # #               #         #   # #   # # # # # #
### ### ### # # # ### # # # # ##### # # ##### # # ######### # # # # # ##### # ############# # # ################# ### # # ### # ### ### #
#         # # # #   # # # # #     # # #     # # #         # # # # # #     # #         #   # # #                 #   # # #   # #   #   # #
### # # ### # ### # ##### # # ### # # ### ####### # # ### # ##### # ######### # ### ### ##### ### ############### # # # ########### # # #
#   # #   # # #   #     # # #   # # #   #     #   # #   # #   #   #         # #   #         #   #               # # # # #     #   # # # #
# # # # ### ##### # # # # ### ####### # ### ### # # # # ### ##### # ### # ### # ##### # # ### ### # ##################### ##### ##### # #
# # # #   #   #   # # # #   #       # #   #   # # # # #   #   #   #   # #   # #     # # # #     # #             #       #           # # #
# ### # ### # ### # # # ### ### ### # ### # # ### # # ########### # # # ##### # # ##### # ### ### # ##### ### # # ####### ### # # ### ###
#   # # #   # #   # # #   #   #   # #   # # #   # # #         #   # # #     # # #     # #   #   # #     #   # #             # # #   #   #
# # # # # # # ### # ##### ### # ### # # ### ####### ### ##### ##### ### # # # ### # ##### ######### # # # ######### # ##### # ##### #####
# # # # # # # #   #     #   # #   # # #   # #     #   #     #   # #   # # # #   # #     #         # # # #         # #     # #     #     #
# # # # # ### # # # ########### ############# ################### ### # # # # ### # # ### ####### ### # # # ### ### ######### ### #######
# # # # #   # # # #         # # #   # #                             # # # # #   # # #   #       #   # # # #   #   #         #   #   #   #
# # ##### ### ### # # ### # # ### ### # ######### ####### # # # ### # ### # # ### ### ### # # # # ##### ################# # ##### ### ###
# #     #   #   # # #   # #               # #   #       # # # #   # #   # # #   #   #   # # # # #   # #                 # #     #       #
# ### # ##### ### # # ### # ### # # ##### # # ######### # ########### ### # # # ### # ### # ######### ### # ####### ### ### # # # ##### #
#   # #   #   #   # #   # #   # # #     # #         # # #     #     #   # # # #   # #   # #             # #       #   #   # # # #     # #
# # # # # # # ### # ### # # # ##### ####### ##### # # ######### ############# # ######### ### ####### # # ############### ####### # #####
# # # # # # # #   #   # # # #   #               # #                   # # #   #         #   #       # # #               #     #   #     #
# # # ### # # ### # ### # # ### # # # # # # # ### ##### ### ########### # ### ### ### ### # # ### # # # # # # # ### # # # # ##### # # # #
# # # #   # # #   #   # # #   # # # # # # # #   #     #   #                 #   #   #   # # #   # # # # # # # #   # # # # # # # # # # # #
# # # # # ### ### # # # # # # # # # # # # ##### # # ### ### # # # ########### # # # ### # # ### ##### # ### ### # # ######### # # # # ###
# # # # #   # #   # # # # # # # # # # # #     # # #   #   # # # #           # # # #   # # #   # #   # #   #   # # #       #   # # # # # #
# # ##### ### # # # ### ### ### # # # # # # ### # # ### # ### # ############# ### # ##### # # ### ##### # # ####### ######### # ####### #
# #     #   # # # #   # #     # # # # # # #   # # #   # #   # #             #   # #     # # #         # # # #     #     #               #
# # # # # # # # # # # # ### ####### ### # # # # # # # # # # ### ########### # ######### ### # # # # ### ##### ########### ####### ### # #
# # # # # # # # # # # #   #       #   # # # # # # # # # # # #             # #         #   # # # # #   #               #         #   # # #
# # # # # ##### # # # # # # ### # # # # ##### # ######### ####### # # ####### ### # # # # # # # # # ########### # # ### ### # # # ### # #
# # # # # #     # # # # # #   # # # # #     # #         #       # # #       #   # # # # # # # # # # #   #     # # #       # # # #   # # #
# ### # # ### ### # ### # # ##### # # # # # ### ### ########### ##### ################# # # ####### # ### ### # ### # # # # # # ####### #
# #   # #   # #   #   # # #     # # # # # #   #   #           #     #                 # # #   #             # #   # # # # # # #       # #
##### # # ####### # ### # # ####### # # # # # # # # # # ######### ######### ############# # ### # # ####### ##### # # ### # # # # # # ###
#     # # # #     #   # # #       # # # # # # # # # # #         #         #             # #   # # #       #     # # #   # # # # # # #   #
### # ### # # # # # ##### # # # ### # # ### # # # # # # # # # # # ### ##### ### ##### ### # # # # # # # # # ### # # # # # # ####### #####
#   #   # #   # # # #     # # #   # # # #   # # # # # # # # # # #   #     #   #     #   # # # # # # # # # #   # # # # # # # #     #     #
# # # ##### # # # # ### # # ##### # ### ### # ### ### # # # # # # # ##### # ############### ### ### # # ### ##### ### # # # # ### # # ###
# # #   #   # # # # #   # #     # #   #   # #   #   # # # # # # # #     # #               #   # #   # #   #     #   # # # #     # # #   #
# # # # # ### # # # ### ### ### # # # # # # ##### ####### ##### # # ### ########### ##### # ####### # ### # # # # ############# # ### # #
# # # # # #   # # # #   #     # # # # # # #     #     # #     # # #   #           #   # # #     #   #   # # # # #             # #   # # #
# ### # ##### ### ### # # # # ##### ### # # # ### ##### ### # ##### # # # ######### ### ### ### ### # # ### # ####### ##### # # ##### # #
# #   # #       #   # # # # # #   #   # # # #   #         # #     # # # #         #     # #   #   # # #   # #       #     # # #     # # #
##### ####### ### ### # ### # ### # # ### # # # # # # # # ### ### # # # # ### ### ####### ##### ### # ### ### # # # ### ### ### # #######
#       #       #   # #   # #     # # #   # # # # # # # #   #   # # # # #   #   #             #   # #   # #   # # #   # # #   # #       #
# # # # # ### ### # # # # ### ##### ####### ##### # # # # ############# ##### ############# # # # ### ### ### # # # # ### # ### ##### # #
# # # # # #     # # # # # #       #     #       # # # # #             #     #             # # # # #     # #   # # # #   # #   #     # # #
# # # # ### # # # ### # # ### # # # # # ### ##### # ##### # # ####### ####### ##### # # # # # ### # # ### # # ##### # # # ### # ##### ###
# # # # #   # # #   # # # #   # # # # # #       # #     # # #       #       #     # # # # # # # # # #   # # #     # # #     # #     #   #
### # ### # # # # ##### # # # # # # ####### # ### # # ### # # ##### # # ##### # ####### ### ### # ### # # ### ################### ### # #
#   # #   # # # #   #   # # # # # #     #   #   # # #   # # #     # # #   # # #     # #   #     #   # # # #                     #   # # #
# # ##### # # ### # # ### ### ### # ##### # # # ### ### # # # ####### # # # ######### ########### # # # ##### # ######### # ### ##### ###
# #   #   # #   # # # #     #   # #     # # # # #     # # # #       # # #                 #     # # # #     # #         # #   #     #   #
# # # ### # # ### ##### # # # ### ### # # # # # # # # ### # ######### # # ########### # ### ######### ### # ### # # # # # ##### ##### # #
# # # #   # # #     #   # # #   #   # # # # # # # # # #   #         # # #           # #             #   # #   # # # # # #     #     # # #
# # # ### # ##### # ### # # # ### # # ### # # # # # ### ### ### # # ##### ### # # # ########### # ### # # ##### # ##### # # ########### #
# # # #   # #     # #   # # #   # # #   # # # # # #   # #     # # #     #   # # # #           # #   # # #     # #     # # #           # #
# # # ### # # # # # # # # ### ### ### # # # # # ### # # ### ### # ##### # ##### ######### # # ### ### # # ##### # ### # # # # # ### #####
# # # #   # # # # # # # # #     #   # # # # # #   # # # #     # #     # #     #         # # #   #   # # #     # #   # # # # # #   #     #
# ### # # ### # # # # # # ### # # # ### ### # # # # # # # # # # ### ################# ### # # # ##### # ##### ### # # # # # # ### ### ###
# #   # # #   # # # # # # #   # # #   #   # # # # # # # # # # #   #                 #   # # # #     # #     #   # # # # # # #   #   #   #
# # # # # ### ### # # # # ### # # ### # ### # # # ##### # ### # # ######### ### ### ### ##### ##### # # ### ### # # ####### # ### # #####
# # # # # #     # # # # # #   # #   # # #   # # # #     #   # # #         #   #   #   #     #     # # #   #   # # #       # #   # #     #
# ### # # # # ##### ### # ### # # ######### # ### # # # # ### # ### # # # # ### # ####### # ######### ### # ### # # # # # ### # ##### # #
# #   # # # # #   # #   # #   # #       #   #   # # # # #   # #   # # # # #   # #       # #         #   # #   # # # # # # # # #     # # #
### ### # ### ### # # # ### # # # # # ##### # ### # # # ##### ##### # # # # # # ##### # # # # ### ######### ### ##### ### # # ### # ### #
#   #   # # # #     # #   # # # # # #     # #   # # # #   #       # # # # # # #     # # # # #   #         #   #     #   # #     # #   # #
### ##### # # # # # # # # # # # # # # # ### # # # # # # # # # ### # # # # ##### ##### # ### # ### # # # ######### ####### # # # ### ### #
#   #       # # # # # # # # # # # # # #   # # # # # # # # # #   # # # # #     #     # #   # #   # # # #         #       # # # #   # #   #
# ##### # # ##### # ### # # # ### ### # # # ##### # # ### # # # # # ### # # # # # ##### # ### # # # ########### # ######### # # # ##### #
# #     # #   #   # #   # # #   #   # # # #     # # # #   # # # # #   # # # # # #     # #   # # # #           # #         # # # #     # #
# # # # # # ### # # ### # ### ########### # # # ##### # # # # # # # ### # # ### # ####### ### # ### # ### # ######### ####### ######### #
# # # # # #   # # #   # # #           #   # # #     # # # # # # # #   # # #   # #       #   # #   # #   # #       # #   # # # # #   # # #
# ##### # # # # # # # ### # # # # ######### # ##### # # # # # ####### ### ### ### ##### # ### # # # ####### # # # # ##### # ### # ### # #
# #     # # # # # # # #   # # # #         # #     # # # # # #       #   #   #   #     # #   # # # #       # # # #           #         # #
# # ### ### # ##### ##### ### # ######### ########### ####### # ### ######### # # ### ##### ####### ##### ### # # # ######### ##### #####
# # #     # # # #   #     #   #         #           # #       #   #         # # #   #     #     #       #   # # # #               #     #
# ### # # ### # ### ### # ### # # # # ### ### ######### # ### ### # ### # # # ### # # ### ### # ### # ### ##### # # ### ### # ######### #
# #   # #   #     # #   # #   # # # #   #   #         # # #     # #   # # # #   # # #   #   # # #   #   #     # # #   #   # #         # #
##### # # # # ### # # # ####### ##### # # # # ##### # ### ### # ### # # # # # ### # # ### ##### ### # ######### ### ### # # #############
#     # # # #   # # # # # #         # # # # #     # # #   #   #   # # # # # # # # # #   #     # #   #         #   #   # # #             #
### # # # ### ### ### ### ##### # # # ### # ##### # ### ### # # # # # # ### # # # ### # # ######### # ### # ### ##### # # # #############
#   # # #   #   #   # #         # # #   # #     # # #   #   # # # # # #   # # #     # # #         # #   # # # #     # # # #             #
# # ### # ### ### ##### # ### # # ### # # # # # # # ####### ##### # ### ####### # # ######### # # # # ##### # ##### ########### # #######
# #   # # #     # #     # #   # # #   # # # # # # # #           # #   #       # # #         # # # # #     #       #           # #       #
### # # # ### ### ##### # ### # # ### ### # # # # # ### # # ### # ##### # # # # # ### ##### ### # # # # ########### # ### ### # # # # ###
#   # # #   # #     #   # #   # # # #   # # # # # # #   # #   # #     # # # # # #   #     #   # # # # #           # #   #   # # # # #   #
### # ### ### ### # ### # ### # # # # ### ##### # # ### # # ### # ##### ### ### # # # # ### ### ### # ####### ### # ### # # # # # # #####
#   # #     # #   # #   # #   # #   #   #     # # # #   # #   # #     #   #   # # # # #   #   # #   #       #   # #   # # # # # # #     #
### ##### ### # # ### # ##### ### # # # # # # # ### # # # # ### # ##### # # # # # # ########### ##### ### # ####### ########### ### #####
#   #       # # #   # # #       # # # # # # # # #   # # # #   # #     # # # # # # #           #   # #   # #       #           # #       #
# # # ### # # ### ### # ##### ### # # ### # # # ### ### ### ##### ### ### # ### # # # ############# # # ### # ##### ####### # ##### #####
# # # #   # # #     # #   #     # # #   # # # #   # #   #       #   #   # #   # # # #             # # #   # #     #   #   # #     #     #
######### # ### # ##### ### # ### ### # # ######### # # ### ### # ##### ### # # # # # ############# ################# # ### ####### ### #
#     #   # # # #   #   #   #   #   # # #       # # # # #     # #     #   # # # # # #   #     # #   # #             #     #     # #   # #
# # # # # # # ### # ##### # # ##### ####### # # # # # ### # # ### # # ### # ##### # # ### ##### # ### # ########### # # ######### # #####
# # #   # # #     # #     # #     #       # # #   # # #   # #   # # #   # #     # # #                             # # #           #    x#
#########################################################################################################################################
