#########################################################################################################################################
#o                  # #     #     #   # #           #           # # # #   #                           #     #               #           #
# ### ############### # ##### ##### ### # ########### ########### # # # ### ############### ### # # # # ##### ####### ##### # ####### # #
#   #             # #                 #                         # #       # #             #   # # # #               #     #         # # #
# # # # ##### # # # # ################# ############### ### ##### # ####### # ####### # # # ### # ### ######### ##### ########### # # ###
# # # #     # # #       # #                 #         #   # # #   #   #             # # # #   # #   #         #     #           # # #   #
# # # # ##### ### # # ### # ######### ####### ### ##### # ### # ### ### ##### ### ### ########### ##### ####### ########### # # # #######
# # # #     #   # # #               #         # #   # # # #   #             #   #   #           #     #       #     #     # # # #       #
# ### ##### # # # # ##### ### ### ####### ##### ##### ##### ### ######### ####### ##### ##### ### ##### ##### ####### ### # # ### #######
# #       # # # # #     #   #   #       #             #       #         #       # # # #     # # #     #     # #         # # #   #       #
# # # # # # # # ### # # # ### ####### ##### # # # ##### ####### ##### ######### ### # ######### ### ##### # ### ####### ### # # # ### ###
# # # # # # # #   # # # #   #       #     # # # #         #         #         #                   #     # #           # # # # # #   #   #
### ### ####### # # ### # # ####### ### # ######### ####### ### ############# ### ##### ######### # # # # ##### ######### ##### # #######
#     #       # # #   # # #       #   # #   #     # #         #             #   #     #     #   # # # # #     #               # #       #
### ####### ##### # # # # # # # ### # ### # # ####### ### # # # ############# # # # ### ### # ##### # # ####### ### ################### #
#         #     # # # # # # # #   # #   # #             # # # #           #   # # #   #   #       # # #       #   # #                 # #
# # # ### ####### # # # # ### # ### # # # # # # ### ### ##### ### ############### # ### ##### # ##### ########### ### ######### ### # ###
# # #   #     #   # # # #   # #   # # # # # # #   #   #     #   # #       #     # #   #     # #     #           #             #   # # # #
### # # ### ##### ### # ##### # ### # # # ### ########### # ####### ####### ### # # ### # ### # # ############# ####### # # ### # # ### #
#   # #   #     #   # #     # #   # # # #   #           # #                   # # #   # #   # # #             #       # # #   # # #     #
### # ##### # # # # # # # ### # # # ### # # # # # # # # ### ### ##### # ##### ### # # # # # # # # # # # # ### ####### # ####### ####### #
#   #     # # # # # # # #   # # # #   # # # # # # # # #   #   #     # #     #   # # # # # # # # # # # # #   #   #   # #       #       # #
### # ### # # # # ### # # ### # ### ##### ### # # # # # # # ### # # ####### ### # # # ### ##### # ##### # ####### ######### ### ##### # #
#   #   # # # # #   # # #   # # # #   #     # # # # # # # #   # # #       #   # # # #   #     # #   # # #                 #   # #   # # #
# # # # ##### # # ### # ####### # ### # # # # ########### # # # ### # # ##### ### # ### # # # ####### ########### # # # # ####### #######
# # # #     # # #   # #       #     # # # # #           # # # #   # # #     #   # #   # # # #             #     # # # # #               #
# # # # # ############# ####### # ##### # # # # # # # # ### # ### # # ##### ######### ### # # # ### # # # # ####### # ### ### ###########
# # # # #           #         # #     # # # # # # # # #   # #   # # #     #         #   # # # #   # # # #         # #   #   #     #   # #
# ### # # # # ####### # ######### ##### ### # # # # ####### # # ##### # # ##### ######### # # # ### # # # # # ### # # # # # # ### # ### #
#   # # # # #       # #         #     #   # # # # #       # # #     # # #     #         # # # #   # # # # # #   # # # # # # #   #       #
# ### # # # ### ##### # # # # ### # # # ### # # # # # # ##### # ##### # ### ####### ##### # ### ### ##### ### # ######### ### ####### # #
# #   # # #   #   #   # # # #   # # # #   # # # # # # #     # #     # #   #       #     # #   #   #     #   # #         #   #       # # #
# ### # ### # # ### # # ### ########### # # # # # # # ### # # # ### ### ### # ####### ##################### # # ### # # ##### ##### ### #
# #   #   # # #   # # # #       #     # # # # # # # #   # # # #   #   #   # # #     #                     # # #   # # # #   #     #   # #
# # # # # # # ##### # # ### # ### ##### # # ##### # # # ##### # ### ### ### ### ### ### ### # # ### ########### # # ### # ##### ##### ###
# # # # # # #   #   # #   # #       # # # #   #   # # #     # #   #   #   #       #   #   # # #   #           # # #   #       #     # # #
# ### # # # # # # # # # ### # # ##### ##### ##### # # # # # # # # # ### ######### ####### # # # # # ### ### ############# # # # # ##### #
# #   # # # # # # # # #   # # #         # #     # # # # # # # # # #   #         #       # # # # # #   #   #             # # # # #       #
### # # ### # ### # # # # # # # # # ### # ##### # ### # ##### # # ##### # # # # # ### ### ####### ### # ### # ##### # ### # # ##### # ###
#   # #   # #   # # # # # # # # # #   #       # #   # #     # # #     # # # # # #   #   #       #   # #   # #     # #   # # #     # #   #
# ### # # ####### # # # ### # # ### # # ### ### ##### # # # # ### ##### ### # ### ### # ### ##### # # # # # # # ### # ### ### # # #######
# #   # #       # # # #   # # #   # # #   #   #     # # # # #   #     #   # # # #   # #   #   #   # # # # # # #   # #   #   # # #       #
##### # # ### # ##### # # ######### # # ########### # # # # # ### # ####### # # # ### ##### # ### ### # ####### ### ### ##### # # #######
#     # #   # #     # # #         # # #           # # # # # #   # #       # #   #   #     # #   #   # #     # #   #   # #   # # #       #
# # # ### # ### # # # # # # # # # # # # # ##### ##### ##### # ### # # ####### # # # # # # ### ### ### # ##### # ######### ####### # #####
# # #   # #   # # # # # # # # # # # # # #     #     #     # #   # # #       # # # # # # #   #   #   # #       # #               # #     #
# # # # # # # # # # # # # # ### # # # # # # # ### # ### ##### # ##### # # # # # # # ### ### # # # # ### ### # ### ########### ##### ### #
# # # # # # # # # # # # # #   # # # # # # # #   # #   #   #   #     # # # # # # # #   #   # # # # #   #   # # #             #     #   # #
# # # # ### # ### # ### # # ##### # # ### # ##### ####### ### # # # # # # # ##### # ### ### # ######### ##### # ####### # ### ##### # ###
# # # # # # #   # #   # # #   # # # #   # #     #       # #   # # # # # # #     # #   #   # # # #     #     #         # #   #     # # # #
# # # # # ### ##### ### # # # # # # # # # # ##### # ######### # # ### # # # # # # # ### # ##### # ### ##### # # ##### # ############### #
# # # #     # #       # # # #   # # # # # #     # #       #   # #   # # # # # # # #   # #           #     # # #     # #                 #
# ### ### ### ### # # # # # ######### ### # # # # # # # ##### ### # ##### ### ### # # ### ### # ######### # # # ##### # ##### ###########
#   #   #   #   # # # # # #         # #   # # # # # # #   # #   # #     #   #   # # #   #   # #         # # # #     # #     #           #
# ### # # ### # # # # # # ######### # ### # # ##### # # # # # ##### ### # # # ####### # ##### ############### # # ### # # ### ###########
# #   # #   # # # # # # #         # #   # # #     # # # #   # #   #   # # # #     # # #     #               # # #   # # #   #           #
# ### # ##### # # # # ### # # # ### # ### ### ##### ##### ####### # # ##### ### ### # ##### # # # ##### # # # # # # ### ##### # ##### # #
#   # #     # # # # #   # # # #   # #   #   #     # # #           # #     #   #     #     # # # #     # # # # # # #   #     # #     # # #
# # # # # # # ### ### # # ##### # # ##### ### ##### # ####### # ### ########### ### # # # # # # # ### # # # # ####### # # # # ### # #####
# # # # # # #   # #   # #     # # #     #   #     #         # #   #           #   # # # # # # # #   # # # # #       # # # # #   # #   # #
# ### ### ### ####### ### # ### ### ### # # # # # ########### # # ### ####### ##### # # # # # # # ### ##### # ### # # # # ### # # ### # #
#   #   #   #     #     # #   #   #   # # # # # #           # # #   #       #     # # # # # # # #   #     # #   # # # # #   # # #   #   #
# # # ### ######### # # # # # # ### # # # # # # # ####### # ### # ### # # ### ### # # # ### ### # # # # ### ### # # # # # ### ##### #####
# # #   #       #   # # # # # #   # # # # # # # #       # #   # #   # # #   #   # # # #   #   # # # # #   #   # # # # # #   #     #     #
# ### ##### # ##### ### # ### # # # # ####### # ### ##### ##### ####### ##### # ### ### ##### # ##### # ### # # ####### # ### # # # #####
#   #     # #     # # # #   # # # # #       # #   #   # #     #       #     # # #     #     # #     # #   # # #       # #   # # # #     #
# # # ####### ### # # # ### # ####### # ### # # # # # # # ####### ### # # ### # ### # ####### # # ### # # # # # ##### ### # # # # # # ###
# # #       #   # #   #   # #       # #   # # # # # # #         #   # # #   # # #   #     # # # #   # # # # # #     #   # # # # # # #   #
# # # # # ### ##### # # # ### ####### ### ### # # # ##### # ### # ### # # ######### ####### ##### # # # ##### # ### # ### ### # ### #####
# # # # #   #     # # # #   #     #     #   # # # #     # #   # #   # # #         #             # # # #     # # # # #   #   # #   #     #
# ### # # ### ### # # # # # ##### ### ### ### # ### ### # # ### # ### ### ##### ### ### ### ##### # ##### # # ### ######### ### ### # # #
#   # # #   #   # # # # # #     #   #   #   # #   #   # # #   # #   #   #     #   #   # # #     # #     # # #         #   #   #   # # # #
# # ### # ### # # ### # # # # ##### ######### ##### # ##### ##### # ### # # # # # # ##### ######### ### # ### # # # ### ####### # # # # #
# #   # #   # # #   # # # # #     #         #     # #     #     # #   # # # # # # #               #   # #   # # # # #         # # # # # #
# ### # ##### # # ##### # ### ### ######### # # # # ### ### # ######### # ### # # # ##### # ##### # # # # # ##### ### ####### # ### #####
#   # #     # # #     # #   #   #         # # # # #   # # # #         # #   # # # #     # #     # # # # # #     #           # #   #     #
# ### # ### # # # # # # # # # ### ##### # ### # ### # # # # # ########### # # ### # # ##### # # # ### ##### # # # ### # ########### # ###
#   # #   # # # # # # # # # #   #     # #   # # #   # # #   #           # # #   # # #     # # # #   #     # # # #   # #           # #   #
# ##### ##### ### ### # ### # # ##### ########### # # ##### # # # ### # ##### # # # # # # ### ### ########### ### # ### ### # # # ### # #
#     #     #   # #   #   # # #     #           # # #     # # # #   # #     # # # # # # #   #   #           # #   #   #   # # # #   # # #
# # # # ##### ### # # # # # # # ####### ### ##### # ####### # # # # # # # ### ######### # ####### # ### # # # # # # ### # # # # ##### ###
# # # #     # # # # # # # # # #       #   #     # #       # # # # # # # #   #         # #       # #   # # # # # # #   # # # # #     #   #
# ### # ##### # # # ### # ##### ############# ##### ### ##### # # # ##### ######### ############# ### ### # ##### # # # # # # ##### #####
#   # #     #   # #   # #   #               # # # #   #     # # # #   #           #             #   #   # #   #   # # # # # #     #     #
# # # # ##### ### # # # ####### # # # # ####### # # # # # # # # ####### # # # # # # # ########### ### # ######### # ### ### ### ####### #
# # # #     # # # # # #       # # # # #           # # # # # # #       # # # # # # # #           #   # #   # #   # #   #   #   #       # #
# ##### ####### ##### ##### ### # ### # # # # ##### # # # ### # # # ##### # # ### ##### # ####### # # # # # # ##### # ##### # # # # # ###
#   #       #   #   #     # #   #   # # # # #     # # # #   # # # #     # # #   #     # #       # # # # #         # #     # # # # # #   #
# ##### ##### ### ######### ### # # # ### # ####### # # # # # # # ######### ##### ### # ####### ### ####### # # ####### # # ### # #######
#   #   #           #     #   # # # #   # #       # # # # # # # #         #     #   # #       #   #       # # #       # # #   # #       #
# ##### # ### ####### ######### # # # # # # # ######### # # # # # ############# ######### ### # ### ### ########### # # ### # # # ##### #
# # #       #   #             # # # # # # # #         # # # # # #         #   #         #   # # #     #           # # #   # # # #     # #
# # ### # # ##### ### # ######### # # ### ### # # # ##### # # ### # ####### ##### # # ##### ####### # # ##### ### ### ### # ##### #######
# # #   # #         # #     #   # # #   #   # # # #     # # #   # #   # #       # # #     #       # # #     #   #   #   # #   #       # #
### ### ##### ### ### # ##### ### ### # # # # # # ### ### # ### # # # # # ####### ### # ### ########################### # ##### # # ### #
#           #   #   # #   #     #   # # # # # # #   #   # #   # # # #           # # # #   #               #           # #     # # #     #
# # ### # ### # # ### # # # ##### ##### # # ### ### ##### # ######### # # ######### ##### ################# ######### ##### ##### ##### #
# # #   #   # # #   # # #       #     # # #   #   #     # #         # # #           # # # #         #               #     #     #     # #
# # # # # # # ### ##### # ########### ### # ### # ################### ### # ### ##### # ### ######### ### ############# ######### # # # #
# # # # # # #   #     # #           #   # #   # #     #           #     # #   #   #   #       #         #     #       #   #     # # # # #
### ### ##### # ######### ####### ### # # ##### ####### ##### ####### ### ######### ### ####### ########### ### ######### # ##### # #####
# # #       # # # # # #         #   # # #     #             #       # #                                   #             #       # #   # #
# ##### ### # # # # # ### # ### # # # ### # ### # ### # ### # # ##### ### # # ### # ##### # ### # # ##### ### # # ########### # ####### #
#         # # #         # #   # # # #   # # #   #   # #   # # #     #   # # #   # #     # #   # # #     #   # # #           # # # #     #
##### # # # # # ### ##### # # # ### # ### # ### # # ### # ##### # ### # # ### ### ### # # # ####### # ### # ### # ############### # #####
#     # # # # #   #     # # # #   # #   # #   # # #   # #     # # #   # # # #   #   # # # #       # #   # #   # #           # # #       #
# # # # # # # # # # # ####### ####### # # # # # ### # # # # ### ##### # ### # ### # # # # # # ### # # # ####### ### ### # ### # # #######
# # # # # # # # # # #       #       # # # # # #   # # # # #   #     # # #       # # # # # # #   # # # #       #   #   # #     #         #
# ### # # ##### # # ####### # ##### # ### ### ##### ### # # # ####### ### # # ### # # ### # # ### # # ##### # # # # # ####### # ####### #
#   # # #     # # #       # #     # #   # #       #   # # # #       # #   # #   # # #   # # # #   # #     # # # # # #       #         # #
# # # # # # # # ### # # # ##### ### ##### ### ######### ### # # # ### # # ### # # ####### ### ##### # # ######### ##### ##### # ### #####
# # # # # # # # #   # # #     # # #     # #         # #   # # # # #   # #   # # #       # #       # # #         #     #     # #   #     #
# ### # # ### # # # # ### # # ### ### ####### ### ### # ### # ### ### # # # # # # ##### ### # # ### # ### # # ### ####### # # # # #######
#   # # #   # # # # #   # # #       #       #   #     #   # #   # #   # # # # # #     #   # # #   # #   # # #   #       # # # # #       #
# ##### # # # ##### # # ### ####### ### ##### ##### ### ### # ### ### ### # # ### ### ##### # # # # # ### # ##### # # # ####### ### ### #
#     # # # #     # # # #         #   #     #     #   #   # # # #   # #   # #   #   #   #   # # # # #   # #     # # # #       #   #   # #
# ##### # ### ### # # ####### ### ### # ### # ######### # # # # ### # # # # # ### ####### # # # # ### # ### ##### ### ### ##### # # #####
#     # # #     # # #       #   #   # #   # #         # # # #     # # # # # #   #       # # # # #   # #   #     #   #   #     # # #   # #
# ### ####### # # ### ######### ##### ### ### # # ####### # # # ####### # ### # # ##### # # # # # # ### # ### # # # # ######### ####### #
#   #   #     # # #           #     #   # #   # #       # # # #       # # #   # #     # # # # # # #   # #   # # # # #         #       # #
# # # ##### # ##### # ##### # ####### # ############### ### # # # ####### # # # ##################### # # ####### # # # # # ####### ### #
# # # #     #     # #     # #       # #               #   # # # #       # # # #                     # # #       # # # # # #       #     #
# # # ### ### # ##### # ### ################# # ####### ##### # # # ##### ### ##### # # ############### ##### # ### ### # # # ### # # ###
# # #   # #   #   #   #   #             #   # #       #     # # # #     # # #     # # #           #   #     # #   #   # # # #   # # #   #
# # # ####### ### ### # # ### # ######### ##### # ### ######### # ######### # ### # ############### ############### ### # ### ### # # ###
# # #       #   # #   # #   # #               # #   #   #     # #         #     # #     #               # #       # # # # # #   # # #   #
### # ### ### ### ### # # # # # # # ### ##### # # ####### ### ########################### ########### ### # ######### ##### # # # ### ###
#   #   # #     #   # # # # # # # #   #     # # #           #               #           # # #   # # # # #     #         #   # # #   # # #
### # # # # # # # # # # # ### # # # # # # ################################### ### ####### # # ### # ### # ##### ######### ########### # #
#   # # # # # # # # # # #   # # # # # # #           #         #   # # # #   # # #   # #   # #   # #                         #     # # # #
### # # ##### # # # ##### # # ### # # # ############# ######### ### # # # ### # ##### # ### # ### # ############# ### ### # # ##### ### #
#   # #   #   # # # # #   # #   # # # #             #         # #       #           # #   # # #                 #   #   # #             #
### ### # ### # # # # ### # # ##### # # ### ### # ### ######### # ####### ########### # ### # # ####### # # # ##### # # # ##### # ### ###
#     # #   # # # #     # # # #   # # #   #   # #     #   #   # #       # #         #     #           # # # #     # # # #     # #   #   #
### ### # ### # ########### ### ##### # # ############# ### ### # ####### # ######### ##### ##### # ### ### # ### # # # # # ### # # #####
#     # #   # #         #           # # #                                                       # #   #   # #   # # # # # #   # # #    x#
#########################################################################################################################################
