#########################################################################################################################################
#o                # # #           # # #                                         #           #   # #           # # #           # # # #   #
# # ############### # # ########### # # ############# ### ######### # ### # ##### ########### ### # ### # ##### # # ### ####### # # ### #
# #             # #           # #   #   # #         #   #         # #   # #                           # #     #       #             # # #
# # # # ######### # ### # ### # # ### ### # ########### ##### ### # ##### ### # ### ############# ############# ########### # ### ### # #
# # # #               # #   #                       # #     #   # #     #   # #   #     #       # # #     # # #     #     # # # # # # # #
# ### ### # # ####### ### ######### ### # ##### ##### ############### # # # # ##### ### # ### # ### # ##### # # ##### ######### ### # # #
#   #   # # #       #   #         #   # #     # # #                 # # # # #     #   #     # #               # #   # # # # #           #
# # ##### # ##### # ##### # ####### ### ####### # # ############### # # ######### # # ################# ##### # # ### # # # # ### # # # #
# #     # #     # #     # #       #   #       #                   # # #         # # #     # # # #     #     # # #               # # # # #
# ### # ### ### # # ### ####### # ############### # # # # # # # # ############### # # # ### # # # ####### ##### # ######### ### ### # ###
#   # # #     # # #   #       # #               # # # # # # # # #               # # # #                 #                 #   #   # #   #
# # # # # # # # ### ##### ################### ### # ####### ### ############# ############################### ##### ####### #############
# # # # # # # #   #     #                   #   # #       #   #           # #     #                   #     #     # #     #             #
# # ##### # ### # # ### # # ########### # ######### ####### ############# # ######### ############# # # ####### # ### ############# #####
# #     # #   # # #   # # #           # # #     # #       #             #                         # #         # #                 #     #
### # # # # # # # # # ### # # # # # ##### # ##### # # # ### ################# ######### # ##### ################### ### # # ####### #####
#   # # # # # # # # #   # # # # # #     #       #   # #   #                 #         # #     # # #     # #       #   # # #       #     #
# # ### ### ##### # # ### # # # ### ### # # ### ####### ### ### ############# ####### ### ####### # ##### # ######### # ##### ### ### ###
# #   #   #   #   # #   # # # #   #   # # #   #       #   #   #     #     # #       #   #   #   #         #         # #   # #   #   # # #
### # # ### ### # ### # # ### ##### ### # # # ### ### # ##### ####### ##### ####### ########### # ### # # # ##### ######### ### ####### #
#   # #   #   # #   # # #   #     #   # # # #   #   # #     #                   # #       # #       # # #       #             #     # # #
### ### ### ### # # # # ##### # ########### # # ### # ### # ##### ### ######### # ######### # ########### # ### ### ##### ### ##### # # #
#     #   #   # # # # #     # #           # # #   # #   # #     #   #         #           #             # #   #   #     #   #   # #   # #
# # # # # # # # # ### # ### # # # ##### ########### # # # ### ##### # # ### ############### ################### # ####### ### # # ##### #
# # # # # # # # # #   #   # # # #     #           # # # #   #     # # #   #       #                           # #       #   # # #       #
# # ### ### # ##### # # # # # # ### ######### # # # # # # # ########### ### # # ### ######### # ################### # # ######### #######
# #   # #   #   #   # # # # # #   #       # # # # # # # # #           # # # # #             # #                   # # #               # #
# # # # ### # # # # ### ##### # ### ####### ####### ### ### # ########### # ############# # # # ##### ##### # ### ##################### #
# # # # #   # # # # #       # #   #               #   #   # #             #             # # # #     #     # #   #                       #
# # # # ### # # # # ### ##### ### # # ####### ##### ### ### # ######### ##### # ####### ##### ### # # ### # ################# ### ### # #
# # # # #   # # # #   #     #   # # #       #     #   #   # #         #     # #       #   # #   # # #   # # # #             #   #   # # #
### # ### # # # ### ### # ### # ####### # # ### ### ####### # # ######### # # # # # # ##### ### # ### ####### # ############# # ### #####
#   # #   # # #   #   # # #   #       # # #   #   #       # # #         # # # # # # #         # #   #         #             # #   #     #
# # # # # # # # # # ### ### # # # # # # # ### ####### # ### # ### # ### ### # # ##### # ######### ### ### ##### ################### # ###
# # # # # # # # # # #     # # # # # # # #   #       # #   # #   # #   #   # # #     # #         #   #   #                         # #   #
# # ### # # # # ### ### # ### # # # ### # ############# # # # ### # # # # # # # # ### # # ########### # # ####### ### ###################
# # #   # # # #   # #   #   # # # #   # #             # # # #   # # # # # # # # #   # # #         # # # #       #   #             #   # #
# # ##### ### # ### # # ##### # ### # ######### ### # # # # # ##### ### # # # # # # ### # # ####### ########################### ### ### #
# # #       # #   # # #     # #   # #         #   # # # # # #     #   # # # # # # #   # # #               #       # #       # #     #   #
### # # # # ### # # ### # # # # ### # ##### # # # ######### # ### ### ### ### # ######### # ##### ### ##### ####### # ### # # ####### ###
#   # # # #   # # #   # # # # #   # #     # # # #       #   #   #   #   #   # #         # #     #   #   #   #           # #             #
# # # ### # # # ### # # ### # ### # ##### # ### ### # # # # # ### ####### # # ##### ##### # ### ########### # ######### # ##### # #######
# # #   # # # #   # # #   # #   # #     # #   #   # # # # # #   #       # # #     #     # #   #                       # # #   # #       #
### # # # # # # # # # # ##### # ### ########### # # ### ### ### # # # ### # ####### # ### # ### # # ### # ##### ### ### ### ########### #
#   # # # # # # # # # #     # #   #           # # #   #   #   # # # #   # #       # # #   #   # # #   # #     #   #   #               # #
# # # # ### # # ##### # # ##### ### ##### # ####### ### ### # # ### ####### ### # # ##### # # # ### # # ##### # ### # ### # ### # # ### #
# # # # #   # #     # # #     #   #     # #       #   #   # # #   #       #   # # #   #   # # #   # # #     # #   # #   # #   # # #   # #
# ### # # # # # # ### # # ##### ####### ####### # # ### # # ####### # ##### ### # # # ##### ##### # # # # # # # # # # ##### # ### # ### #
# #   # # # # # # #   # #     #       #       # # #   # # #       # #     #   # # # # #         # # # # # # # # # # #     # #   # #   # #
# # # # # # ### ### # ### # # # ### ### ####### # # # # # # ### ##### # ####### # ####### # # # # # # # # # # ##### # # ### ### # # #####
# # # # # #   #   # #   # # # #   #   #       # # # # # # #   #     # #       # # #   #   # # # # # # # # # #     # # #   #   # # #     #
# ### # # # ### # # # # # # # # ### # ##### ### ### ####### # # ### # ### # ### # # ##### # # # # # # # ### ### ### ### # # # # # # ### #
#   # # # #   # # # # # # # # #   # #     #   #   #       # # #   # #   # #   # # #     # # # # # # # #   #   # #     # # # # # # #   # #
# # # ##### ### # # # # # # ### # # # ### ##################### # ### ### ######### ##### # ### ####### # ####### # # ### # ####### #####
# # # #       # # # # # # #   # # # #   #                   # # #   #   #               # # #         # #       # # #   # #       #     #
# ### ### # # # ####### # # # # ### # # # ######### ### ##### ####### ### # # ####### ### ##### # # # # # ####### # ### # # ####### ### #
#   # #   # # #     #   # # # #   # # # #         #   #             #   # # #       #   #     # # # # # #       # #   # # #       #   # #
# # ### # # ### ####### # # ### ##### # ##### # ##### # ##### # ##### ################### # ### # # # # # # # ##### # ######### ### # # #
# #   # # #   #     #   # # #     #   #     # #     # #     # #     #                 #   #   # # # # # # # #     # #         #   # # # #
# ### # # # # # # ### # # # ### # # # # # # ### # # ########### ######### # ### ### # ### # # ### ##### ### # ##### # # ##### ##### #####
#   # # # # # # # #   # # # #   # # # # # #   # # # #         #         # #   #   # #   # # #   #     #   # #     # # #     #     #     #
# # ### ### ### ### ### # ##### ####### # # ### # ### ### ##### # # ####### ### ### ##### ### ####### # # ### # # # ########### ### # ###
# #   # #     #   # #   #   #   #   #   # #   # #       #     # # #       #   #   #     # #         # # #   # # # #           #   # #   #
# ##### ### # # ####### # # ### # ##### # # ### # # ### # # # # # ######### ### ### # # ### # # # # ####### # ### # # ### ### ##### # # #
#     # #   # #       # # # #         # # # #   # #   # # # # # #         #   #   # # # #   # # # #       # #   # # #   #   #     # # # #
# ##### # # ### # # ##### # ### # # ### # # ### # # ### # # ####### ### # # # ### # ### # # # # # # ##### ### # ### # # # # # # ##### # #
#     # # #   # # # #     # #   # #   # # #   # # #   # # #       #   # # # #   # #   # # # # # # #     #   # #   # # # # # # #     # # #
# ### # ### ### ### # ### # # # ### # # # # # # ### ### # ##### ####### # # ####### ####### # # ### # ### # ### ### ### # # # # #########
#   # #   #   #   # # #   # # #   # # # # # # # #     # #     #       # # #       #     #   # #   # #   # #   #   #   # # # # #         #
# ##### # # # # # ### # # # # ##### # # # # # # ### # # # # # # # ####### # ### # ####### # # # # ### ##### # # # # ### ### # # # #######
#     # # # # # #   # # # # #     # # # # # # #   # # # # # # # #       # #   # #       # # # # # # #     # # # # #   #   # # # #       #
# # ### ### ######### # # ### # ### # # # ######### ### ##### # # # # # ############# ##### # # ### ####### ### # # ##### ### # #########
# #   # #           # # #   # #   # # # #         #   #     # # # # # #             #     # # #           #   # # #     #   # #         #
# ### # ### # ### ### ### ### # ### # # # ####### ##### ### # # # # ### ##################### # # ### ### ##### ##### ### ##### # # ### #
#   # # #   #   #   # # #   # # #   # # #       #     #   # # # # #   #                     # # #   #   #     #     #   # #     # #   # #
# ### # # # # ### # ### # # # # # # # # # ############# # # # # # # # ##### # ################# ### ### # # # # # # # # # ##### # #######
#   # # # # #   # # #     # # # # # # # #             # # # # # # # #     # #                 #   #   # # # # # # # # # #   #   #       #
# ######### ### ### # # # # ####### ##### ##### # # ##### # # # # # ####### ##### # ### # ##### # # # ### ####### ##### # ####### # # # #
#       #     #   # # # # #     # #   #       # # #     # # # # # #       #     # #   # #     # # # #   #     # #     # #       # # # # #
# ####### # # # ##### # # # # # # ##### # # # ##### # # # # # ### ##### ### ########### # ### # # ### # # # ### # ### ########### # # # #
#       # # # #   #   # # # # #       # # # #     # # # # # # #       # # #           # #   # # #   # # # #     #   #           # # # # #
# # ### ### # # ### # # ### # ##### ### # # ######### ##### # # # ### # # # # ### # # ### # # ##### # # # # # ### # # # # # # # ##### # #
# #   # #   # #   # # # #   #     #   # # #         #     # # # #   # #   # #   # # #   # # #     # # # # # #   # # # # # # # #     # # #
### ##### # # # # # # ##### # # # # # ### # ### # ######### # ### # ####### # # ### # # # ################# # ### # ##### # ### # # ### #
#       # # # # # # #     # # # # # # #   #   # #       # # # #   #       # # #   # # # #               #   #   # #     # #   # # #   # #
# # # # # # # # ##### ### # ############# # # ### # ### # ####### ######### ##### # # ### ### # ##### ##### # # ############# ######### #
# # # # # # # # # #     # #     #         # #   # #   #     # #           #     # # #   #   # #     #   # # # #             #         # #
# # # ### # # ### ### # # # ### ### # # # ####### # ####### # # # # # ########### # # # # # # ##### ##### ### # # # # ### # # # ##### # #
# # #   # # #     #   # # #   #   # # # #     #   #       #   # # # #           # # # # # # #     #         # # # # #   # # # #     # # #
# # # # ### # # ##### ##### # # # ####### # # ### # ##### # # # # # ### ##### # # ### # ####### ######### ##### ### ######### ##### #####
# # # # #   # #     #     # # # # #       # #   # #     # # # # # #   #     # # #   # #       #         #     # #         # #     #     #
# # ### # # # # ### # # # # # # # ### # # # # # # # # # ### # ### ### # # # # ##### # # ### ### ##### ####### ##### # # # # ##### # ### #
# #   # # # # #   # # # # # # # # #   # # # # # # # # #   # # #     # # # # #     # # #   #   #     #       #   #   # # #       # #   # #
# # ### ### # # ### # # ### ### # # # # # # # # # ##### # # # # # # # # ### # ##### ### # ### # # # ##### # # # ### # ##### ### ### #####
# #   # #   # #   # # #   #   # # # # # # # # # #     # # # # # # # # #   # #     #   # #   # # # #     # # # #   # #     #   #   #     #
# # # ### # # # # # # # ##### # ### # # ### # # # ### # # ### ### # ##### ### ######### # # # # ### ### # ### ####### # # # # ######### #
# # #   # # # # # # # #     # #   # # # #   # # #   # # #   #   # #     #   #         # # # # #   #   # #   #       # # # # #         # #
# # # # # ### # # # # # # ### # # # # # # # # ### # # # # # # # # # # ### # # ####### # # ### ########### # # # # # # ### # ### # # ### #
# # # # # #   # # # # # #   # # # # # # # # #   # # # # # # # # # # #   # # #       # # #   #           # # # # # # # # # #   # # #   # #
# ### # # ### # # # # ### # # # # # ### ##### ### ##### # # # ### ####### ### ##### ### # # # # ##### # # # # # # # ### ### ### ### #####
#   # # # #   # # # #   # # # # # #   # #       #     # # # # #         # # #     #   # # # # #     # # # # # # # #       #   #   #     #
# # ### ##### # # ### # # # # # # # ### # ### ### # # # ##### ### ### ### # # ### ####### ### # # # ### ### # # # # # # #################
# #   # #     # #   # # # # # # # #   # # #     # # # #     # #     # # #   #   # #     #   # # # #   #   # # # # # # #               # #
# ### # ### # # # ##### # # ### ##### # # # # # ### # ### # # # # # ### ########### ################# ##### ####### # # ### ########### #
#   # # #   # # #     # # # #       # # # # # #   # #   # # # # # #     #             #     #       #     #   # #   # #   #     #       #
# # # # # # ### # # # # ####### # ### # ### # # # # # ### # # # ### ##### ############# ##### ##### ########### ### # # ######### ##### #
# # # # # #   # # # # #       # #   # # # # # # # # # # # # # # #                           #     #     #   #     # # # #             # #
# # # ### # ##### # # # # # ### # # # # # ##### ##### # ##### # ### # ### # # # ####### # # # ########### ### ########### ###############
# # #   # #   #   # # # # # #   # # # #     #       #       # # #   #   # # # #       # # #     # # #             #     #               #
# # # # ### # # # # ### # # # # # ### # # ##### # ### # ##### # ### # # # # # ##### ############# # # ##### ####### ##### ### ### #######
# # # # #   # # # #   # # # # # #   # # #   #   #   # #     # # #   # # # # #     #         #             #                 #   #       #
# # # # # # # ### # # ### # # # # ### # # # ### ####### ### # # # # # # ### # # # ####### ### ##### ################# # ##### # ##### ###
# # # # # # # #   # #   # # # # #   # # # # #         #   # # # # # # # #   # # #       #         #                 # #     # #     #   #
##### ### ### ### # # ### # # # # # # ### ### # # ##### # # # # # # # # ### # # # # # # # # # # ######### # ##### # ### # # ####### #####
# #     #   #   # # #   # # # # # # #   # #   # #     # # # # # # # # # #   # # # # # # # # # #         # #     # #   # # #       #     #
# ### # ##### ### # # ##### ### # # # ##### # ### ##### # # # # # # # # ##### # ##### ### # ### ### ### # ### # ### ### # # ##### # # # #
#     #     # #   # #     #   # # # #     # # #       # # # # # # # # # #     #     #   # #   #   #   # #   # #   # # # # #     # # # # #
### # # ######### # # ### # # ### # # # ### # # # # ### # ##### # # # ##### # # ### # ######### # ### ####### # ##### # # ######### # # #
#   # #         # # #   # # #   # # # # #   # # # #   # #     # # # # #     # #   # #         # #   #       # #       # #         # # # #
# # # # # # ##### # # ####### # # # # # ### ##### ##### # # ### # # # ### # # # # ### # ####### # # # ##### ########### ### ####### #####
# # # # # #   #   # #       # # # # # #   # #         # # #   # # # # #   # # # #   # # #     # # # #     #           #   #       #     #
### # # # ####### # # # # ### # # # # # # # # ### ### ##### # # ### # ### ### # ##### ### ##### # # ### # ### # # # # ### # # ####### # #
#   # # #     #   # # # #   # # # # # # # # # #     #     # # #   # # #   #   #     #         # # #   # #   # # # # #   # # # #     # # #
####### ##### ### # ### # # # ### # ### # ### # # # # ####### ########### # # # # # # ### # # ##### ### # ### # ##### # ### # # ### #####
#           # #   # #   # # #   # #   # # #   # # # #       #   #         # # # # # #   # # #     #   # #   # #     # #   # #     #   # #
##### # # # # # ### ##### # # # # # # # ##### # # # # ####### ### ####### # # # ### # # # # ### ### ##### ##### ####### ######### ##### #
#     # # # # # #       # # # # # # # #   #   # # # #       #   # #       # # #   # # # # #   #   #   #       #       #         #     # #
# # # # ### # ##### # ##### # # ### ######### ### ### # ##### ########### ### # # # # ### # # # ### # ### ### # ### # ### ############# #
# # # #   # # #     #     # # # #         #     # # # # #   #       #       # # # # # #   # # #   # #   #   # #   # #   #     #       # #
### # # ### # ### # # # ### # # ### ##### ### # # # # # # ##### # # # # # # ### ################### # # # # ### # # ### ####### ####### #
#   # # # # # #   # # #   # # #   #     # #   # #   # #       # # # # # # # #                     # # # # #   # # #   #             # # #
# # # ### # ##### ### # # ##### ### ######### # # # ### # ### ######### # ### # # # ### ##### # # ##### ### # # ##################### # #
# # #   #     # # # # # #   # #   #     # # # # # #   # #   #         # # # # # # #   #     # # #     #   # # # #         #             #
# # ####### # # # # # ### ### # ### # ### # # # # ### # # ####### ##### ### # # ############# ##### # ##### ### # ######### #############
# #     #   # #     #   #     #   # #     #   # #   # # #       #     #   #   #             #     # #     #   #                        x#
#########################################################################################################################################
