#########################################################################################################################################
#o            #   #   #               # # #             # # #                 #   # #                 # #   # #             #           #
# ### ####### # ### ### ############### # # ### ######### # # ############# ### ### # ####### ####### # # ### # ##### # ##### ##### #####
#   # #     #   #                 #     #     #           # #     #       # #   #           #       #               # #     #     #   # #
# ##### ######### ### ### ######### ### # ##### ########### # ##### ######### ### ############# # ########### ##### ######### ######### #
#                   #   #   #         #       #         #           #   # #     # # # #       # #       # # #     #         #           #
# # ### # # # ### # ### ##### ####### ##### # ############# ##### ### ### # ##### # # # ################# # ####### ######### ####### ###
# #   # # # #   # #   #             #     # #     # #   # #     #   #   #                     #               #   #                 # # #
# ######### ### # # ####### ##### # # # ########### # ### # ##### ### ### ### ######### # # ### ############### ############# ### ##### #
#         #   # # #       #     # # # #         # #   #         #           #         # # #                                 #   #       #
# # # ### ####### # # # # # # # # ### # ######### # ### ##### ### ### ### ### ### # ####### ##### # ######### # # # ### # ########### ###
# # #   #       # # # # # # # # #   # # # # #               #   #   #   #   #   # #       #     # #         # # # #   # #       # # #   #
# ### # # # ##### # # ### # # # # # # ### # # ##### ### ##### ##### ######################### ##### ### # # ### # ############### # #####
#   # # # #     # # #   # # # # # # #             #   #     #     #     # # # # #           #     #   # # #   # # # #   #           #   #
# ### # # # # # # ### ### # ##### ### # ### ##### # ##### # ### ######### # # # # ################# ### ### ####### # ### ######### # ###
#   # # # # # # #   #   # #     # #   #   #     # #     # #   # # #         #       #       #     #   # #       # # #             #   # #
# ##### ### # # # ### # ### # # ######### ##### ##### # ### ### # # ######### ####### ####### ### ##### ######### # # ####### ### # ### #
#   #     # # # #   # # #   # #       # #     #     # #   #   #                                 #     # #   #               #   # #     #
# # ### # # ##### # ### # # # # ####### ####### # # # # ### ######### # ### ####### # ### # # ########### ### ######### # # ### # # # # #
# #   # # #     # #   # # # # #               # # # # #   #         # #   #       # #   # # #         #         #     # # #   # # # # # #
# # # # ### # ##### # ##### # ### # ### # ####### ### ############# # ### ######### ##### # ### # ##### ##### # # ##### ####### # # # ###
# # # #   # #   # # #   #   #   # #   # #       #   #             # #   #         #     # #   # #           # #       #       # # # #   #
# # # # ### # # # ######### # # # # ### # # # # # ####### ### # ### ### # # ############### ##### ### ### # ####### ##### # # # ### # # #
# # # # #   # #           # # # # #   # # # # # #       #   # #   #   # # #               #     #   #   # #       #     # # # # # # # # #
# # # # ### ### # # # ##### ### ### ##### # ################# # ### # # # ### # ######### ### # # # ### # # ########### ######### #######
# # # #   #   # # # #     #   #   #     # #                 # #   # # # #   # #         #   # # # #   # # #           # #               #
### # ### # # ##### ### # # # ### # # ### # ####### # ### ######### ##### # ### ### # # ######### # ### # ### ### # # ### ### ### # #####
#   #   # # #     #   # # # #   # # #   # #       # #   #         #     # #   #   # # #         # # # # #   #   # # #       #   # #     #
### # ### # # # # # # # ### ######### # # # # # # ##### ### ### # # ####### # ### ### # # ########### ### # # # # # ############# # #####
#   #   # # # # # # # # #           # # # # # # #     #   #   # # #       # #   #   # # #               # # # # # #   # #       # #     #
# # # # ### # # ####### ### # # # ##### # ### # ### ### # ######### # ### # # ### ### ### # # ####### # ### # # # ### # # ##### # # #####
# # # #   # # #       #   # # # #     # #   # #   #   # #         # #   # # #   #   #   # # #       # #   # # # #   #       # # # #   # #
### ### ##### # # # ### ### # # ##### ### ### # # ### # # ### ### ### # ### ##### # # # ### # # # ##### # ### # # ######### # ### ##### #
#     #     # # # #   #   # # #     # #     # # #   # # #   #   #   # #   #     # # # #   # # # #     # # #   # #         # # # #   # # #
### ### ### # ### ### # # # ########### # # ### ####### # # # # # # # # ############# # ##### # # # # # # # # # # ########### # ##### # #
# #   #   # #   #   # # # # # #     # # # #   #       # # # # # # # # #       #     # #     # # # # # # # # # # #                   # # #
# # ########### # ### # # # # # ##### ############### # # # # # # # # # ####### ####### # ### ### # # # ##### # # ######### ######### # #
#             # #   # # # #                         # # # # # # # # # #               # #   #   # # # #     # # #         #     #       #
### # ### ######### ### ### # # # ### # ######### # ##### ### ### ### # # ### ##### # # ##### ### ########### # # # # ### # ### # #######
#   #   #         #   # #   # # #   # #         # # # # #   #   #   # # #   #     # # #     # # # #         # # # # #   # #   #         #
# # # # ####### # ### ### # # # ##### # # ### ### ### # ######### # # ### ### # # ### ####### # ### ########### # # # ##### # ### ##### #
# # # #       # #   #   # # # #   #   # #   #   #               # # #   #   # # #   #       #         #       # # # #     # #   #     # #
### # # # ############# # # # # ######### # ### # # ##### ### ### ### ### # ### # ################### # ######### # # # ### # ### # #####
#   # # #             # # # # #       # # #   # # #     #   #   #   # #   #   # #       #           #     #     # # # #   # #   # #   # #
# # # # # ##### # # ##### # # # # # # # ######### ##### # # ##### ### ### # # # # # ##### ##### # ### # # # ### ### # # # # # # # # ### #
# # # # #     # # #     # # # # # # #           #     # # #   # #   #   # # # # # #           # #   # # #     #   # # # # # # # # #     #
### # # # # # # # ### ####### # # # # # # # ##### ### ######### ### ##### # ### # # # # # # ##### # # ####### ### ### # ### ### ### #####
#   # # # # # # #   #       # # # # # # # #   # #   # #           #     # #   # # # # # # #     # # #       #   #   # #   #   #   #     #
# # # # # # # ### # # # ##### # # # # # # # # # ### ### ############### # # ### # # # # # # # ### # ### ####### # ### # ### ####### #####
# # # # # # #   # # # #   #   # # # # # # # #     #                   # # #   # # # # # # # #   # #   #       # #   # #   #       #     #
##### # # # ##### # # ##### # ##### # # # ### # ############# # ##### ### ##### # # ### # # # # ### ############### ### ### ### ### ### #
#     # # #     # # #   #   #     # # # #   # #             # #     #   #     # # #   # # # # #   #               #   # # #   #   #   # #
# # # # ####### ### ####### # # ##### # # # # # # ####### # ##### ####### ##### # # # # # # ### # ### ########### # # # # # # # # # #####
# # # #       #   #       # # #     # # # # # # #       # #     #       #     # # # # # # #   # #   #           # # # #   # # # # #     #
# # ### # ### ##### # # ### # # ##### ### ### # # ######### # ########### # # # # # # # ### # # # ##### # # ################### # # # ###
# # #   #   #     # # #   # # #     # #     # # #         # #           # # # # # # # #   # # # #     # # #       # #         # # # # # #
# # ### # # # ######### # ##### # # ### # # ### ############# # # ### # # # # # ### # # ### ### # ##### ### # # ### # ######### # ### # #
# # #   # # #         # #     # # # #   # #   #             # # # # # # # # # #   # # #   # #   #     #   # # #   #         # # # #     #
# # # # # # ### # ############# ### # # # ############### ####### # ############### ### ### ### # # # ##### # # # # ##### # # ### ### ###
# # # # # #   # #             #   # # # #               #       #       #         #   #   #   # # # #     # # # #       # #     #   #   #
# ### # # # ### ### # ##### ##### # ### # # ### # ########### # # ####### ### ##### # # # # ### # # # ### # # # # ### # # # # # ##### # #
#   # # # #   #   # #     #     # # #   # #   # #           # # #   #       #     # # # # # #   # # #   # # # # #   # # # # # #     # # #
# # # # # # ### # # ### # ### # ##### # # # ### # # ######### ##### # ##### ### ####### # ### # ##### # ### ##### # # # ### ### ##### ###
# # # # # # #   # #   # #   # #     # # # #   # # #         #     #       #   #       # # #   #     # #   #     # # # #   #   #     #   #
# ##### # ##### # ### # # ### # # # # # ### # # ### # ####### ##### # # # # ### ### ##### # ### ### # # ### ##### ##### ### ######### ###
# #     #   #   #   # # #   # # # # # # #   # #   # #     # #     # # # # #   #   #     # # #     # # #   #     #     # #           #   #
# # # # ##### # # # # ### # # # ### # # ### ### ### # ### # ##### ##### ##### ### # ##### ##### # # ### # ### # # # # # # # # # # # # ###
# # # #   # # # # # #   # # # #   # # # #     #   # #   #       #     #     #   # # # #     #   # #   # #   # # # # # # # # # # # # #   #
# # ### ### ### ### ##### ##### # # # ### # ### ##### # # ### # # ############# ### # # ####### # # # # ### ### # ### ##### # ### ##### #
# # #         #   #     #     # # # # #   #   #     # # #   # # #             #   # # # #     # # # # #   #   # #   #   #   # #       # #
# # ### ##### # ### ########### ####### ### # # # ### ### # ##### # ##### ########### ### ##### # ### # # ### # ##### ### # ####### ### #
# # #       # #   #         # # #     # #   # # #   #   # #     # #     #         # #         # #   # # #   # #     #   # #       #   # #
# ### # ### ### # # # ### # # ### ######### ##### ### # # # ####### # ### ######### # ########### ########### ### ### # ### ### # # ### #
# #   #   # #   # # #   # #           #         #   # # # #       # # # #                   #               #   #   # #   #   # # #   # #
# # # # ##### # # ######### # ####### # # # # ### # # # # # # ### # ### # # ################### # # ##### # # # # # # # # # ### # ### # #
# # # #   #   # #         # #       # # # # #   # # # # # # #   # #     # #           # # #   # # #     # # # # # # # # # #   # #   # # #
### # # ####### ### # # # # # # # ##### # # # # ####### ##### ### ### ### # # # ####### # # ### # # ### ### # ####### ### # ##### # # ###
#   # #     #     # # # # # # # #     # # # # #       # #   #   #   #   # # # #               # # #   # # # #       #   # #     # # #   #
# # # # # ##### # # ### ##### # # ### # # # # ### # # ### ### # ##### ##### # # ### # ### # # ### ##### # # ### ##### ##### # ### # ### #
# # # # # #     # #   #     # # #   # # # # #   # # #       # #     #     # # #   # #   # # #   #     #   #   #   #       # #   # #   # #
### # # ##### # # # ##################### # # # ##### ### # ##### ##### # ##### ##### ### ### ### # # ##### ### # ### # ### ### ##### # #
#   # #   #   # # #             #       # # # #   #     # #     #     # #     #     #   #   #   # # #     #   # #   # #   #   #     # # #
# # # # # ### # # ####### ##### # ####### # # ### ### # # # # # ### # # # ##### # ### # # # ### ### # # # ### # # # # # # # ### # # ### #
# # # # #   # # #       #     #         # # #   #   # # # # # #   # # # #     # #   # # # #   #   # # # #   # # # # # # # #   # # #   # #
# # # # # ### ### ######### ##### # ####### # ##### # # ### # # ##### ######### ####### # # # ### # # # # # ##### # ##### # ### # # # # #
# # # # #   #   #         #     # #     #   #     # # #   # # #     #         #     #   # # #   # # # # # #     # #     # #   # # # # # #
# ### # # # # # # # # # ####### # # # ### ### ### # # # ### # # ##### # # # # # # # ### ### # # # # ### ##### # # # # # # # ### # # # # #
# #   # # # # # # # # #       # # # #   # #     # # # #   # # #     # # # # # # # #   # #   # # # #   #     # # # # # # # #   # # # # # #
# # # ### # ##### # # # ########### ######### ####### # # ### # ### # ### # ### ### # # ### # ### ############### # ##### # # # ### # # #
# # # #   # #     # # #     #   # #         #     # # # #   # #   # #   # #   #   # # # # # #   #               # #   #   # # # # # # # #
# ### ### ##### ### # ### # # ### ######### ####### # ### # # # # ### # # ####### ##### # ### # ### # # # ####### # # ### ####### # # ###
#   # #     #   #   #   # #               #         #   # # # # #   # # #       #     #     # #   # # # #       # # # #           # #   #
# # # # # # ### # # # # # # # ##### ##### # ### # # # # # # # # ##### ##### # ### ### ### ### ##### # ### ##### # ####### # # # ##### ###
# # # # # # #   # # # # # # #     #     # #   # # # # # # # # #     #     # #   #   #   #   #     # #   #     # #       # # # #     #   #
# ### # # ##### # # # ####### # ##### ### # ##### # # ##### ### ### ##################### ########### # ####### ######### # ### # # #####
#   # # #   #   # # #       # #     #   # #     # # #     # #     #                     #           # #       # #     #   # #   # #     #
# # ### # # ### # # # ### # # # # # ##### # # ####### # # ### # # ####### # ##### ### # # ####### # # ########### ### # # # ### # ### ###
# #   # # # #   # # #   # # # # # #     # # #       # # #   # # #       # #     #   # # #       # # #               # # # # #   #   #   #
# # ### # # # # # # # # # ### # # ### # # ####### # # # ####### # # # ### # # # ##### ### # # # ####### # ### ### ####### # ### # ### ###
# #   # # # # # # # # # #   # # #   # # #       # # # #     #   # # #   # # # #     #   # # # #       # #   #   #       # #   # #   #   #
# # ##### # ### ### # ### # ##### # ##### ### # ####### ##### # ### # # # # ### # ### # # # # ##### # ### ####### ### ### ### ### # # ###
# #   #   # #   #   # # # #   #   #     #   # #       #     # #   # # # # # #   #   # # # # #     # #   #       #   #   #   #   # # #   #
# # ####### # # # ### # # ### ### ### ####### ######### # # ####### # # # ##### ### ### # ### ##### # ### ##### ### ##### # # ### # # ###
# #   #     # # # #     #   # # #   #       #       #   # #       # # # #     #   #   # #   #     # #   #     #   #     # # #   # # #   #
# # ########### ### # ### # ### # ######### ### # ##### ####### # ##### # # ### # # ### # ### # ######### # ####################### # ###
# #     # #       # #   # # #             #   # # #   #       # #     # # #   # # #   # #   # # # #     # #                       # #   #
# # ##### # # # ### # ##### ### # # ### ######### # ########### # ### ##### ### # # ### # ### ### # ######### ### ### ##### ######### ###
# #     #   # #   # #     # #   # #   #   #     #             # #   #     #   # # #   # # #                 #   #   #     #         #   #
### # ### ##### # # # # ### # # # # # ### # ### ### ##### # ### ########### # # # # # # ##### # # # # # # ####### # # # # # # ####### ###
#   # #   #     # # # #   # # # # # #   #     #   #     # # #             # # # # # # #   #   # # # # # #       # # # # # # #       #   #
# # # ####### # # # # ####### ### # ### ### ##### ############# # ####### # ### ### # # ### # ### # ##### # # ### ####### # ####### # # #
# # #   #     # # # #       # #   #   #   #     #         # # # #       # #   #   # # #   # #   # #     # # #   #       # #       # # # #
### # ### # # # # ### ### # ### # # # ########### ### # ### # # ####### # # ### # # ### ##### ### # # ### # # ################# ### # ###
#   #   # # # # # #     # # #   # # #           #   # #       #       # # #   # # # # #     #   # # #   # # #                 #   # #   #
### # # ### # # # # # # ######### # ### # # # ### ########### # # # # # ### ##### # # ####### ### ### # # # # ### ### # ####### # ### # #
#   # # #   # # # # # #       #   #   # # # #   #           # # # # # #   #     # #         #   #   # # # # #   #   # # #     # #   # # #
### # # ### # ### # # # # # # # ### ##### # # # # ######### ### # # ### # # ####### # # ### # ### # ##### ### ### # ##### ####### # ### #
#   # # #   # #   # # # # # # # #       # # # # #         #   # # #   # # #     #   # #   # #   # #     #   #   # #             # #   # #
##### # # # # ### # # # # # ### ### # # # # # ### # # # ######### # # # # # ####### ### ### # ### ### # # ### # ### # # ######### # ### #
#     # # # # #   # # # # #   # #   # # # # #   # # # #         # # # # # #       #   #   # #   #   # # #   # #   # # #         # #   # #
### # # # ### # # ### # # # ### ### ### ### # # ### ##### ### # # # ##### # # # # # ### # # ### # # ### # ### ### # # ########### # # ###
#   # # #   # # # #   # # #   # #     #   # # #   #     #   # # # #     # # # # # #   # # #   # # #   # #   #   # # #   #   # # # # #   #
# # # # # ### # # # # # # ### # # # ### ##### ### # # # # # # ########### ######### ### ### ##### # # # # # # # ### ##### ### # # # #####
# # # # # #   # # # # # #   # # # #   #   #     # # # # # # #           #     #   # #     #     # # # # # # # # #               # #     #
##### ### # ### # # # # # # # ##### ### ### # ####### # ### # ### ### # ####### ####### ##### ### # # ### ### ### # ##### ### # ####### #
#       # # #   # # # # # # # #       #   # #       # #   # #   #   # #               #     # #   # #   # # #   # #     #   # #       # #
### # ### ##### # ##### # # # # ### # # ##### ### ### # ### # # ############### ##### # # ### # # ### # # # ##### # # ### # ### #########
#   #   #   #   #     # # # # # #   # #     #   #   # #   # # #   #       #   #     # # #   # # #   # # #       # # #   # #   #       # #
### # # # ### # # ### # # # # ##### ### ##### # # # # # ### ### ### ####### ### ### ### # ####### # ### ########### # ### ####### # ### #
#   # # # #   # #   # # # # # #       #     # # # # # #   #   #               #   #   # # #     # #   #           # #   #       # #     #
##### ### ### # # ### ####### ##### # # ######### # ### # ####### ########### # # ### ##### ########### ####### ##### ##### ### # # # ###
# #   #   #   # #   #       # #   # # #         # #   # # #   # #   #   #   # # #   # #               #       # #   #     #   # # # #   #
# ### # # # # # # # # ### ### ### # # # ######### # ### ### ### ##### ### ############# ##### ####### # # # ##### ### # ### # ##### #####
# #   # # # # # # # #   #   # #     # #         # #   #     #     # # # #                   #       # # # #         # #   # #     #     #
# ### ####### # # # ####### ### # # ########### ### ##### ### ##### # # # ########################### ####################### ######### #
#       #     # # #       #   # # #           #   #     #                                           #                       #         #x#
#########################################################################################################################################
