#########################################################################################################################################
#o                    #                         # #                             #     #       #   # #       #   #         #   #       # #
# # ########### ##### # ####### ### ############# # ############### ####### ####### ### ####### ### # ####### ### ##### ### ### ### # # #
# #           #     #         #   #     #                         #     # # #     #       # # # # # #   #             #           # # # #
# ### ### ### ########### # ### # ####### ### # ### ########### ######### ### ##### ####### # # # # # ### ############### ##### # ##### #
#   #   #   #           # #   # #     #     # #   #           # # #                 #             #                     #     # #   #   #
# ### ##### # ##### ##### # ##### ##### ##### ##### ##### ####### # ### ##### # # # # ############# ####### ### ########### # ### # ### #
#   #     # #     #     # #     #   #   #   #     #     #             #     # # # #     #   #             #   #           # #   # # #   #
# ### # # ### ########### # ####### # ### ####### ####### # ######### # ####### ##### # # ### ##### ######### ### # # ####### # # ##### #
#   # # # #             # #       #             #     # # #       # # #       #     # # # #       #         #   # # #     # # # #     # #
# # ##### # # # ### # ####### ##### ##### # ######### # ### ####### ####### ### ### # ### # ### ####### # # # ##### ####### ########### #
# #     # # # #   # #       #     #     # #         #     #               #   #   # #         #       # # # #     #                 # # #
# # ######### ##### # # # ##### ################### ####################################### ########### ####### ##################### # #
# #         #     # # # #     #       # #     #   #               # #   #   #             #           #     # # # #               # # # #
# # # # # # # # ##### ### ### ### ##### # ##### ### ############# # # ### ### ### ### ##### # ####### ####### ### # ##### ##### ### # # #
# # # # # # # #     # # #   #   #                 #       #     # #     #       #   #     # #       # # # #             #     #   #     #
# # # ####### # ##### # # # # ##### # ### # # ##### # ##### ####### ##### ####### ####### # # # # # ### # # ##### # ##### ######### #####
# # #     #   #     #   # # #     # #   # # #     # #                           #       # # # # # #             # #     #   #           #
# # # # # ### ### # ######### ### # # # ######### ####### ######### # ############# ### ### # # ########### ### # # # ####### ##### #####
# # # # #   #   # #         #   # # # #         #       #       # # #       #   # #   #   # # #           #   # # # #             #     #
# ### # # # # # ######### ### ####### # # # ####### ### ### # # # ### # # # # ### ################# ##### # ### # # ##### ###############
# #   # # # # #         #   #       # # # #       #   #   # # #     # # # #                       #     # #   # # #     #           #   #
### # # # # # # # # ### ### ######### # ######### ##### # # ### # ### # # ####### # # # # ############# ### # ##### # ##### # # ##### ###
#   # # # # # # # #   #   #         # #         #     # # # # # #   # # #       # # # # #             #   # #     # #     # # #         #
# # ### ### # ### # ### ### # # # ### # # # # # # # # # ##### # # ### # ### # # ### ### # ##### # ### ######### ### # # # ##### # ### ###
# #   #   # #   # #   #   # # # #   # # # # # # # # # #       # #   # #   # # #   #   # #     # #   #         #   # # # #     # #   #   #
### ### ##### ### ##### ##### # # # # # # ### # # ################### # # ### ### # # # # # # # # ######### ### # # ### # ##### # ### # #
#     #   # #   # #   #     # # # # # # #   # # #                   # # #   #   # # # # # # # # #         #   # # #   # #     # #   # # #
# # # # # # ####### ### # # ### # ### # # ### ### ######### ### # ### # # ### # # ### ##### ### # # ########### ### # # ### ### ### #####
# # # # #             # # #   # #   # # #   #   #         #   # #   # # #   # # #   #     #   # # #           #   # # #   #   #   #   # #
# # # # # ##### # # ##### # # # # ##### ### # # ######### # ### ### ### ##### ### ############### ### # ### # # ####### ### ### ####### #
# # # # #     # # #     # # # # #     #   # # #         # #   #   #   #     #   #               #   # #   # # #       #   # #           #
# # # # # # # ### # ### ### # # # ##### ####### # # ### ####### ### ########### # ##### ######### # # # # # ### ### ### ### # # ### # # #
# # # # # # #   # #   #   # # # #   # #       # # #   #       #   #           # #     #         # # # # # #   #   #   #   # # #   # # # #
# # # ### # # # # # # # ##### # # # # ### ##### # # # ####### # ##### # # # ### ### # # ### # ######### # ##### # ############# ##### ###
# # #   # # # # # # # #   #   # # #     #     # # # #       # #     # # # #   #   # # #   # #         # #     # #     #       # #       #
# ### ### # ### # ### # # ####### # ##### ### # # # # # ### # # ####### # # # ### ##### # ######### ################### ##### ####### ###
#   #   # #   # #   # # #       # #     #   # # # # # #   # # #       # # # #   #     # #         #   #   #   # # #         #       #   #
# # # # # # # # # # # ### # ##### # ### # # # # # # # # # ### ### # # ### ### # ### # # ##### ######### ### ### # # ### # ####### ### ###
# # # # # # # # # # #   # #     # #   # # # # # # # # # #   #   # # #   #   # #   # # #     #                         # #       #   #   #
# ### # ### # # # # # ##### ### ### ### ### # ### ### # ### # # # # ### # # ####### ##### ####### ### # # ### # ############### ##### ###
# #   #   # # # # # #     #   #   #   #   # #   #   # #   # # # # #   # # #       #     #       #   # # #   # #               #     #   #
# ### # # # # # # # ####### # # # # # ### ### # # ### # # # # ##### # ### # # # # # # # # ### # # # ####### ############# # #############
# #   # # # # # # #       # # # # # #   #   # # #   # # # # #     # #   # # # # # # # # #   # # # #       #             # #             #
# # # # # # # ### # # ##### ####### # # # # # ### # ### ### # # # # ### # ### ### ### # # # ##### # ######### ####################### ###
# # # # # # #   # # #     #       # # # # # #   # #   # #   # # # #   # #   #   #   # # # #     # #         #                       #   #
# # # # # ### # # ####### ####### # # ##### # ### # ### ### # # ### ####### ##### # # # # # ### ### # ####### ### # ### ######### ##### #
# # # # # #   # #       #       # # #     # #   # #   #   # # #   #       #     # # # # # #   #   # #       #   # #   #         #     # #
# ##### # ### # # # ####### # ##### # ### # # ### ### ####### ####################### # # ######### ##### # # # ### # ### # ##### #######
#     # #   # # # #       # #     # #   # # #   #   #       #       #   #           # # #         #     # # # #   # #   # #     #       #
# # # # # # # # # # # ####### # ### # # # # ##### # ### ### # ### # # ### ##### # # # ### # ### # # ### # ##### ### # ### # # ### #######
# # # # # # # # # # # # # # # #   # # # # #   # # #   #   # #   # #           # # # #   # #   # # #   # #     #   # #   # # #   #       #
# ### # ### # ### ##### # # # ### ####### # # # # # ##### # # ##### # # ### # ### ### # # # ### # # ##### ### ##### # ##### # ### # #####
#   # #   # # #             #   #     #   # # #   #     # # #     # # #   # #   #   # # # #   # # #     #   #     # #     # #   # #     #
# ### # # # # ### ##### # ### ### # ####### ##### # # ####### ########### ##### ### # # ### ### ### ##### ### # ### # # ### # ###########
# # # # # # # #       # #   #   # #       #     # # #       #           #     #   # # #   #   #   #     #   # #   # # #   # #           #
# # # # # # # # # # # # ### # ##### # ##### ##### ### ##### # # ############### ##### # ##### ##### ##### # # ##### # # ### #############
#   # # # # # # # # # #   # #     # #     #     # # #     # # #               #     # #     #     #   #   # #     # # #   #             #
# ########### # # # # # ### ##### ################# ### # # # # # # # # ################# # ### ### ### # # # ####### # ### # # # ### ###
#       # #   # # # # #   #     #                     # # # # # # # # #                 # #   #   #   # # # #   #   # #   # # # #   # # #
# # ### # ### ### # # # ### ############# ##################### # # ### # # ######### # # # ### ####### # # # # # ######### # ### ##### #
# #   #     #   # # # #   #             #                     # # #   # # #         # # # #   #       # # # # #           # # #         #
# # # # # ### ### # # # # ############### ### ### ### # # # # ### # # ### # # ### # ##### ### ### ##### # # # ##### # ##### # ### ### ###
# # # # #   # #   # # # #           #   #   #   #   # # # # #   # # #   # # #   # #     #   #   #     # # # #     # #     # # #     #   #
# # ### # # # # # # # # # # # ##### # ### # # ### # # # # # # ##### # ### # # # # # ####### # ### # ##### ### # # ### ##### # ### ### # #
# #   # # # # # # # # # # # # #   #     # # #   # # # # # # #     # #   # # # # # #       # # #   #     # # # # #   #     # # #     # # #
# # ### # ### ### # # ### ### # ####### ### ### # ########### # # # # # ########### ### # ### # # # ####### # # # # # ### ### ### # # ###
# # #   #   #   # # #   #   #         #   #   # #           # # # # # #         #     # #   # # # #         # # # # #   #   #   # # #   #
# # ### # ### ### # # ### ### # # ### ##### # ### # # ############### ### # ####### # # # ####### # # # ##### # # ### # # ### # # # ### #
# #   # #   #   # # #   #   # # #   #   # # #   # # #             #     # #   # # # # # #       # # # #     # # #   # # #   # # # #   # #
### ### # # # # ### # ##### # # ######### ##### ### ##### ######### # ####### # # # ### # # # ### # # ### ### # ### # # # ### ### # #####
#   #   # # # # #   #     # # #               #   #     #         # #       #     #   # # # #   # # #   # # # #   # # # #   # #   #     #
# # ### # # ### ##### ### ### # # # # ####### # # ### ### ########### # # ### # ### ######### # ##### ##### # # # # ### # # # ### ### # #
# # #   # #   #   #     #   # # # # #     # # # #   #   #       #   # # #   # #   #         # #     #       # # # # # # # # # #     # # #
### # ### # # ##### # ##### ### # # ##### # ########### # ### ### ##### ########### ### ### ####### # ####### # ##### ####### # # # # # #
#   # #   # #     # #     #   # # #     #             # #   #       # # # #       #   #   #       # #       # #             # # # # # # #
# ### ### # # # # # # # ############# ##### # ######### ############# ### # ########### # ### # ####################### ##### ### # # # #
# #   #   # # # # # # #             #     # #         #         #   #   # #   #   #   # #   # #             # #       #     #   # # # # #
### # # # # ### # ### # ### ### ### # ####### ############# ##### ### ### # ### ### ####### ########### ##### # ############### # #######
#   # # # #   # # #   #   #   #   # #       #   #         #                       #       #       #   # # #                   # #       #
# # # # ### ##### # # # # # ### ### ##### # ##### ##### # ### ### ### ########### # ############### ##### # ### # ############### ##### #
# # # # #       # # # # # #   #   #     # # #       # # #   #   #   #           #                             # #   # #         #     # #
# ##### ### # ####### # # # ####### ### ##### ####### ####### # ### ##### # ####### # ### ########### # # ### ##### # # ### # ### # #####
# #   # #   #     #   # # #       #   #                     # #   #     # #       # #   #           # # #   #     #       # #   # #     #
# ### ### # # ### # # # # # # ############### # # # ### ### # # ##### # # # # ####### # ########### ### ##### # ######### # ##### # # ###
# #       # #   # # # # # # #               # # # #   #   # # #     # # # # #     #   #           #   #     # #     #   # #     # # #   #
########### ####### # # # # # # ### # ##### # ### ### # ####### ##### # ### # # # ##### ########### # # ##### # ##### ############# #####
# # #           #   # # # # # #   # #     # # # #   # #       #     # # #   # # #     # #         # # #     # #                   #     #
# # # # # # # ######### # # ### ############### ##### # # ### # ##### ### # # # ##### # # ### # # # # ### ############# ### # ##### #####
#     # # # #       #   # #   #                     # # #   # #     #   # # # #     # #     # # # # #   #             #   # #     #     #
# # # ### # # ### ##### # # # # # ### # # # # # # # # # ####### ######### ### ### # ### # ### # # # # ### ### # ### ### # ### ### ##### #
# # #   # # #   # #   # # # # # #   # # # # # # # # # #       #         # #     # #   # #   # # # # #   #   # #   #   # #   #   #     # #
# # # # ##### # # # ### ####### ##### # # # ### # ### ### # # # ### # ####### # ### ### ### ##### ### # # ######### # # # ### # ##### # #
# # # # #     # #   #         #     # # # #   # # # #   # # # #   # #       # #   #   #   #     #   # # #         # # # #   # #     # # #
# ### # # ### ### ##### # ##### ##### ### # ####### ####### # # # # # ####### # # # ##### ### ##### ### # ### ### ##### # # # # ##### # #
# #   # # #   #       # #   #       #   # #   #   # #     # # # # # #       # # # #     #   #     #   # #   #   #     # # # # #   # # # #
### # ####### ### ##### # ##### ### ##### ### # ### # ########### # # # # # # ##### ####### ### ##### ### # # ### ### # ####### ### #####
#   # # #       #     # # #       #     #   #             #     # # # # # # #     #       #   #     #   # # #   #   # #       #         #
### # # ##### ### # ### # # # # # ##### ######### # # # ### ### # # ####### # # # ### # ### # ########### # # ### # ##### ##### #########
#   #   #       # #   # # # # # #     #         # # # #       # # #       # # # #   # #   # #           # # #   # #     #     #         #
### # ### # # # # ### ### # # # ### ##### # # ######### # ####### ############### ####### # ### # # # ### # ### ### # ##### ##### # # # #
#   #   # # # # #   #   # # # #   # #   # # #         # #       # #           #         # #   # # # #   # #   #   # #     #     # # # # #
# ### ####### ### # # # ##### # ### # ####### ##### ### ### # ##### ### ####### # # ### # # # ### # # # ####### # # ### # # ##### ### # #
# #     #       # # # #   #   #   #         #     #   #   # #         #       # # #   # # # #   # # # #       # # #   # # #   # #   # # #
# # # # ### # # # ### # ### # # ##### # ### ##### # ### # # # ####### ######### # # # ### # # # # # # # # # # # ### # # ####### # #######
# # # # #   # # #   # #   # # #     # #   #     # #   # # # #       #         # # # #   # # # # # # # # # # # #   # # #         #       #
# ### ### # # # # # # # ##### ### ### # # # ########### # # # ##### ########### # # # # ### # ### ##### # # ####### ####### # ### #######
# #     # # # # # # # #   #     #   # # # #           # # # #     #           # # # # #   # #   #     # # #       #       # #   #       #
##### ##### # # # ### # # # # # # # ### ### # ######### # # # # # # # ########### ### # # ### ### ####### ### ### # # # # # # # # # #####
#         # # # #   # # # # # # # #   #   # #         # # # # # # # #           #   # # # # #   #       #   #   # # # # # # # # # #     #
### # # ##### # ### # ##### # # # # ### # # # # # # ### ### ### ##### ##### # ### ######### ####### # ##### ### ### ### ### # # # #######
#   # #   #   #   # # #     # # # #   # # # # # # #   #   # #       #     # #   #                 # #     #   #   #   #   # # # #       #
# ### ### # # # # ##### # # # # # # # ####### # # ############# ##### # ########### ######### ######### ##### ######### ### ### #########
# #     # # # # #     # # # # # # # #       # # #             #     # #           #       # # #       #     #         # # #   #         #
##### # ### # ### ##### # # # # # ### ####### ### ### ######### # # ################# ##### ### ### ######### ########### ############# #
#     # #   #   #   #   # # # # #   #       #   #   #         # # #                 # # # #   #   #       # #                         # #
##### ### # # # # # ### # # # # # ### # ### # # # ##### # ####### # # ### # # # # ##### # # ### ########### # ######### ##### # ### # # #
#       # # # # # # #   # # # # #   # #   # # # #     # #       # # #   # # # # #                   #   #   #         #     # #   # # # #
# # # ##### # ##### # # # ### # # # # # ##### ### # # # ### ### # # # ####### # # # ### ############# ### ### # ### #####################
# # #     # #     # # # #   # # # # # #     #   # # # #   #   # # # #       # # # #   #         # #         # #   # # #   # #           #
# # # # ### # # # # # # # # # # # # # # ##### ### # # # # ### # # # ### ######### # # ########### # ### ############# # ### # ###########
# # # #   # # # # # # # # # # # # # # #   # #   # # # # #   # # # #   #         # # #                 #               #                 #
##### # ### # # ##### # # # ####### # # # # # ####### ##### ##### # ### ######### # ### ##### # ##### # ####### ####### ### ### ####### #
#     #   # # #     # # # #     #   # # #   #       #     #     # #   #   #   # # #   #     # #     # #   #   #           #   #       # #
# # # # # ### ### # ### # # # ####### # ####### ### # # # ### ##### # # # # ### ####### ##### ### ### ### # ########### # # # ##### #####
# # # # #   #   # #   # # # # #       #     # #   # # # #   #     # # # #   #         #   # #   #   #   #       #     # # # #     #   # #
##### # # # # ### # # # # ### # # # # # # # # ####### ### # ##### # # # ##### ########### # # ####### ### ####### ### # ####### ### # # #
#     # # # #   # # # # #   # # # # # # # #         #   # #     # # # #   #             #   #       #   #       #   # #       #   # # # #
### # # # # # # # # # ### ### # # # # # ### # # ### ######### ### # # # # # ##### # # # ##### # ### # # # # ##### ### # ########### ### #
#   # # # # # # # # #   # #   # # # # #   # # #   #         # # # # # # #       # # # #     # #   # # # # #   #     # #         # #   # #
### # # # # # ##### # ### ### # # # ### # # ##### # # ######### ### # ####### ################# ############### ######### # # ### ##### #
#   # # # # #   # # #   #   # # # #   # # #     # # #             # #       # # #   #   # # # #   # #                   # # #       #   #
# ### # ##### ### # # ######### # # ### # # # # ### # ####### # # ##### ####### # ### ### # # ##### # ##################### ##### ### ###
# # # #     #     # #       # # # #   # # # # #   # #       # # #   # # # # #                     # #               # #   #     #       #
# # # ######### # # # # ##### # ### # # ##### ##### # # ### # # ##### ### # # ##################### # ######### # # # # #################
# #           # # # # #       #   # # #     #     # # #   # # #                                               # # #                    x#
#########################################################################################################################################
