#########################################################################################################################################
#o          #         #   #   #                       #     #   #         #             # #   #       #               # # #   #         #
# # ######### ######### ### ### ####### ### ### ### # # ####### # ####### # ############# # ### ####### ############### # ### # #########
# #                                   #   #   #   # # # # # # #         #         # # # # #                                             #
# ####### ######################### ####### # ### ### # # # # # ### # ### ### # # # # # # # ##### ### ####### ########### # # ### # ### #
#       #         #               #   # # # # # # # # #           # #   #   # # # #   # #       #   #       #           # # #   # #   # #
# ### # ########### ######### # # # ### # ##### ### ### ### ############### ####### ### # ### # ### ##### # # # # # ##### # # # ##### # #
#   # #                     # # # # #                     # #             #                 # #   #     # # # # # #     # # # #     # # #
# ### ### # # ##### # ####### ####### ### # ### # # ### # ### ####### ########### ### ########### # # # ########### # ##### ####### #####
#   #   # # #     # #       #           # #   # # #   # #           #     #   # #   #           # # # #           # #     # #     #   # #
# ##### ### # # # # ##### ############### ### # # # # ##################### ### ##### ### # ####### # # ### # # ##### # ### ### ####### #
#     #   # # # # #     #               # # # # # # #                 #             #   # #       # # #   # # #     # #   #             #
# # ####### ####### ####### ######### ##### ##### # # ### ##### # ##### ### ##### ##### ### ####### ##### # ### ############### ##### ###
# #       #       # #   # # #       #           # # #   #     # #         #     #     # #         #     # #   #     #         #     # # #
# ########### # # ### ### ### ##### ####### # ####### # # ##### ##### # # ### # # # # # ### # ########### # ##### ### ####### ### # # # #
#           # # #                 #       # #       # # #     #     # # #   # # # # # #   # #           # #   # # #         #   # # #   #
# # # # ##### ######### # ##### ####### ########### # # # # ### # ### ######### # # ### ### # ######### # ##### ### ### ### ### # # # # #
# # # #     #         # #     #       #           # # # # #   # #   #         # # #   # #   #         # #             #   #   # # # # # #
# # # ########### # # ### # # ### ####### ##### ##### ##### ##### # # # # # # # # # # ##### ############### ##################### # # # #
# # #           # # #   # # #   #       #     # #   #     # #   # # # # # # # # # # # # # #             # # # #                 # # # # #
### ####### ### # # ### # # # ######### ##### ### ######### # ######### ####### ### ### # # ### ####### # ### # ####### # ####### # ### #
#         #   # # #   # # # #         #     #             #           #       #   #       #   #       #               # #       # # #   #
# # # ####### # ### # ### # # # # # ################### # # # ##### ##### ######### # # # # # # # ############### ####### # ####### # # #
# # #       # #   # #   # # # # # # #   # #   #       # # # #     #     #         # # # # # # # #               #       # #   # #   # # #
# # # # # # ### ### # ### # ### ### # ### # ### ####################### ### # ##### ### ### ### ##### ######################### #########
# # # # # #   #   # #   # #   #   #                                   #   # #     #   #   #   #     #                     #             #
# ### # # # ### ########### # # ######### # ##### ####### ### # ################### ### ### ### # ### # ### ############### #############
# #   # # #   #           # # #         # #     #       #   # #     #             #   #   #   # #   # #   #                             #
# # # # # # # # ### ####### ### ### ##### # # ### ####### ########### ####### # ##### ##### # # # # # ##### # # ########### #############
# # # # # # # #   #       # #     #     # # # #         # #                 # #     #     # # # # # #   #   # #       # # #             #
# # # # # # # # ##### ##### # # # # # # ######### # # # ### ########### ### ######### ####### # # ### # ##### # ##### # # ####### # # # #
# # # # # # # #     #   # # # # # # # #         # # # #               #   #         #       # # #   # #     # #     #           # # # # #
# ### # # # # # # # # # # ### # # ### # # # ####### # ### ### ######### ### # ### ####### # # # ### # ########### # ##### # # ##### # ###
#   # # # # # # # # # #     # # #   # # # #     #   #   #   #         #   # #   #       # # # #   # # #         # #     # # #   # # # # #
# # # # # # # ### # # # ####### # ####### # # # # # # ### # ########################### # # # ### # ### ####### # # ##### ### ### ### # #
# # # # # # #   # # # #       # #       # # # # # # # # # #                           # # # #   # #           # # #     #   #       # # #
# # # # # ### ### # # ### ##### # # # # # # # # ### # # # # # ##### ### ### ### # # # # # # # # # # # # # # # ##### ################### #
# # # # # #     # # #   #     # # # # # # # # #   # #   # # #     #   #   #   # # # # # # # # # # # # # # # #     #     # #             #
# ##### # # # # # # # ##### ####### ### # # # # ### # # # # # # ### ######### ### ##### # ### # ### ####### ####### # ### # ##### #######
#   #   # # # # # # #     #       #   # # # # #   # # # # # # #   #         #   #     # #   # #   #       #       # #           #       #
# ##### # # # ### # # # ######### # # # # # # # # # ### # # # # # ##### # # # # # ### ### ### # ### # ##### ### ### # # # # # ####### ###
#   # # # # #   # # # #         # # # # # # # # # #   # # # # # #     # # # # # #   #   #   # #   # #   # #   #   # # # # # #       #   #
# # # # ### # # # # # # # # ##### ##### # # # # # # # # # # # ### # # # # # ####### # ### ####### # # # # ### # # ### ##### ### # # # # #
# #   #   # # # # # # # # #     #     # # # # # # # # # # # #   # # # # # #       # # #         # # # #     # # #   #     #   # # # # # #
# # # # ##### # ### # # # # # ### ##### ####### ### # # # # # ### # # ### ### ### # ### # # # ##### ### # ##### # ######### # # # # #####
# # # #     # # #   # # # # #   #     #     #     # # # # # #   # # #   #   #   # #   # # # #     #   # #     # #         # # # # #     #
### # # ### # ##### # # # ### # # # ##### # ### # # ### # # ### # # ##### # ##### # ##### # ####### ############# ### # # ### # #########
# # # #   # #   #   # # #   # # # #     # #   # # # #   # #   # # #     # #     # #   #   #       #             #   # # #   # #         #
# # ### ##### # # # # # # ### # ##### # # # # # ##### ### # # ##################### ##### # # # ### ### ### # # ##### # # # # ### ### # #
#     #   #   # # # # # #   # #     # # # # # #   #   #   # #                     #     # # # # #     #   # # #     # # # # #   #   # # #
### ####### # # # # ##### # ### # # # # # # # # ##### # # # # ######################### ### # ##### # ### # # # # # ##### ### # ### ### #
#         # # # # #   # # #   # # # # # # # # #     # # # # #                         #   # #   #   #   # # # # # #     #   # #   #   # #
# # # # # # # # # # ### # ##### ####### ### # # # ####### # ##### # ### ##### ### ### ### # # ##### # # # # ### ### ######### # ### #####
# # # # # # # # # #   #       #       #   # # # # #       #     # #   #     #   #   #   # # #   #   # # # #   #   #         # #   #     #
### # # # ### # # # ### # # # ### ### # # ### # ######### ##### # ##### # # # # ### # # # # # # # # # # # # # # ##### # # ########### # #
#   # # # #   # # #   # # # #   #   # # # # # #       #       # #     # # # # #   # # # # # # # # # # # # # # #     # # # # #       # # #
# ### # # ### # ### # # # # ######### ##### # # ####### # # # # # # ### ######### ### # ### # ####### ### # ### ########### # ### ### ###
# #   # #   # #   # # # # #         #       # #     #   # # # # # #   #         #   # #   # #     #     # # #                   # # #   #
# # # # # # # # ### ### # # ### # # ######### # # ####### # ### ####### # # ### ### # # # ### # ### # ##### ### ####### ### # ##### #####
# # # # # # # #   # #   # #   # # #         # # #   #     #   #       # # #   #   # # # # #   #   # #     # #         #   # #         # #
# # ### ### ### ####### ### # # # # # ##### # # ####### # # # # ######### ##### ### # ####### # ### # # ##### # ##### # # # # # # # ### #
# # #     # #         #   # # # # # #     # # #       # # # # #         #     # # # #     #   #   # # #   #   #     # # # # # # # #     #
# # # # # # # # # # ### # # # # # # # ### ##### ### ##### # # # # ##### ##### ### ### ### ### # # ### ### # # # # # ####### ### #########
# # # # # # # # # # #   # # # # # # #   #     #   #     # # # # #     #     #       #   # #   # #   #   # # # # # #       #   #         #
# # ### ### ### ### ### # ##### ### ######### # # ####### ### # # ##### ### ##### # # # # ### # # ### # # # # # # # ####### ### # # ### #
# # #     # #     # #   #   # #   # #       # # #       #   # # #   # #   #     # # # # #   # # #   # # # # # # # #       #   # # #   # #
### ### # # # # ##### # # ### ####### ### # # # # # # # # # ### ##### ### ####### ####### ### # ### # ##### # # ######### ####### ##### #
#   # # # # # #     # # #     # #       # # # # # # # # # # #           #       #       #   # #   # #     # # #         #       #     # #
##### # # ### # # # # # # ##### # ### # # ####### ### ### ### # # # ### ################# ##### ### # # ### ### # # # # ######### ##### #
# # #   #   # # # # # # #     #     # # #       #   # #     # # # #   #   #         #   #     #   # # #   # #   # # # #         #     # #
# # ### ##### # # # # ### ##### ### # ### # # # ##### ### ### # # # # ##### ######### ### ### ### # ### ### # # # # # ### # # ### # #####
#           # # # # # #           # #   # # # #     # #     # # # # #             #     # # #   # #   #   # # # # # #   # # #   # #     #
# # # # # ### # # # # # # # ### ### # ##### # # ### # # # # ### ######### # ### # # ####### ########### ### # # # # # # # ### # # #######
# # # # #   # # # # # # # #   #   # #     # # #   # # # # # #           # #   # #                     #   # # # # # # # #   # # #       #
# # # # # ### # ### ##### # # # ####### ### ### ### # # ##### # # # ### # ### # # # ############### ### # ### # # # # ### ### # # # #####
# # # # #   # #   # #     # # #       #   #   #   # # #   #   # # #   # #   # # # #               #   # #   # # # # #   #   # # # #     #
# # # # # ### ### # # ##### # # # # ############# # ### # # ### # # # # # ### # # # # ##### # ####### # ##### # # # # ### ######### # # #
# # # # #   #   # # # #     # # # #             # #   # # # #   # # # # #   # # # # #     # #       # #     # # # # #   #         # # # #
# ### ### ####### ####### # # # ### # # # ### # # # ##### # # # # ######### # ##### # ############### # ### # # # # # # # # # # ##### # #
# #   #         # #       # # #   # # # #   # # # #     # # # # #         # #     # #               # #   # # # # # # # # # # #     # # #
# ### # # # # # # ####### # # # # # ### # ##### ### # ####### # # # # # # # # ### # ########### ### ### # ### ### ### ##### # ### ### # #
# #   # # # # # # #   #   # # # # #   # #     #   # #     #   # # # # # # # #   # #           #   #   # #   #   #   #     # #   #   # # #
# # # # ### # # ##### ### # # # ### # # # ######### # # ##### # # # # # ############# ### ####### # # # # # # ### # # # ### # # ### # ###
# # # # #   # # #         # # #   # # # #         # # #   # # # # # # #             #   #       # # # # # # #   # # # #   # # #   # #   #
# # # # # # # ### # # ### ##### # # # ##################### # ######### # # # ### # ### # ### ### # ### ### # ### # # # # ### ##### # ###
# # # # # # #   # # # #       # # # #       #             #           # # # #   # #   # #   #   # #   # #   #   # # # # # #       # #   #
# # # # # # ######### # # ######### # # ### # ##### # ##### # # # # ##### ######### ### # # # ##### ### ##### ### # # # # # # # ### # # #
# # # # # #       #   # #         # # #   #       # #     # # # # #     #       #     # # # #     # #       #   # # # # # # # #   # # # #
### ### ### # # ### ### # # # ##### # # # # # ### ####### # # # # ### # # # ### ### ### # ####### ######### # ### # ##### ### # # # # # #
#     # #   # # #   #   # # #     # # # # # #   #       # # # # #   # # # #   #   #   # #       # # #   # # #   # #     #   # # # # # # #
# # ### # # # # ### # ### # # # # ### # ### # # # ####### ### ### # ####### ####### ##### # # ##### # ### ##### ######### ### # ### # # #
# #   # # # # # #   # #   # # # #   # #   # # # #       #   # #   #       #     #       # # #         #     # #         #   # #   # # # #
# # # # # # ##### ####### # # # # # # # ######### ####### ####### # ### ### ### ##### ################# ##### ################# #########
# # # # # #   #   #       # # # # # # #       # #       #     #   #   # #     #     #           #   # # # # # # # # #     #             #
### # # # # # ##### # # # ### ##### # # # # ### ### ####### ##### # ### # # # ### ############### ### # # # # # # # # ### ### # # ### # #
#   # # # # # #     # # #   #     # # # # #       #       #   #   #   # # # #   #                                       #   # # #   # # #
# # # # ### # ####### ### # # # ### # # # # # ### ############### # ##### # # # # # # # ##### ### # # # # ### # # # # ##### # # ### ### #
# # # #   # # #       #   # # #   # # # # # #   #               # #   #   # # # # # # #     #   # # # # #   # # # # #     # # #   #   # #
# # # # # # ### # # # # # # ### # # # # # # # # # ########### # # # # ### # # ### ### # ####### # # # ### ### ####### # # # # # ### ### #
# # # # # # #   # # # # # #   # # # # # # # # # #           # # # # #   # # # #   #   #       # # # #   #   # # #   # # # # # #   #   # #
### ### # # ### ##### # # # ### ##### # # ### # # # # ####### ### # ### # ####### ### ### ### # # # # ### ### # # ##### ##### # ### ### #
#     # # # #   #     # # #   #     # # #   # # # # #       #   # #   # #       # #     #   # # # # #   #   #         #     # #   #   # #
# # # # # # # ####### # # # ### # # # # # # # # ##### # # # # # # # # ##### ##### # # ### # ##### ### # # ### ##### ########### # #######
# # # # # # # # #     # # #   # # # # # # # # #     # # # # # # # # #     #     # # #   # #     #   # # #   #     #       #   # #     # #
# # ### ####### ### # # # # ####### # ### # # # # ##### # ### # ### ### ##### # # ### ### ### ### ### # # ### # # # # # ### ####### ### #
# # #   #           # # # #       # #   # # # # #     # #   # # #     #     # # # #     #   #   #   # # #   # # # # # #   #       #     #
# ### # # ######### # # # # ##### ##### # # ### ### ##### # # # ### ### ### # ##### # # # ### ### # ##### # # ### # ####### ### ##### # #
# #   # # #         # # # #     #     # # # #     #     # # # #   #   #   # #   #   # # #   #   # #   #   # #   # #           #     # # #
# # # # ### ### # # # # # # # # # # # # ### ### # # ##### # # # # # ### # # # # ### # # ### ####### ##### # # # # # ### # # # # # # # # #
# # # # #   #   # # # # # # # # # # # #   # #   # #     # # # # # #   # # # # # #   # #   #       #     # # # # # #   # # # # # # # # # #
# ### # # ### ### # # ##### # ### ### ####### # # # # ### # # # # # ####### # ### # # # # # ### ######### ####### # # # ### ####### # ###
#   # # # #   #   # #   #   #   #   #       # # # # #   # # # # # #       # #   # # # # # #   # #   #   #       # # # # #     #   # #   #
# ### # ### # # ### # # ### # # # ### ##### # # ### # ####### # # # # # # # # ##### ### ### # ### ### ### # # # # # ####### ### #########
#   # # #   # # #   # # #   # # #   #     # # #   # #       # # # # # # # # #   #     #   # #           # # # # # #       #             #
# ### ####### # # # # # # # # # # # ##### ### # ### # # # ### # # # # ##### # # ### # ### # # ################### ### ### # ### #########
# # # #       # # # # # # # # # # #     # #   #   # # # # #   # # # #     # # # #   #   # # #                   #   #   # #   #         #
# # ### # # # # ### # # # # # # ##### ### # # # # # # ####### # ### # ### ### # ### ### # # # # # ### # ### ####### # ### # ### # # ### #
# #     # # # # #   # # # # # #     #   # # # # # # #   #   # #   # #   #   # # #     # # # # # #   # #   #       # #   # #   # # #   # #
# ### ### # ### ### # # ### # # # # # # ### # # # # # # # ### # # # ##### # ##### # ### # # # # # # ### ##### ### # # # # # ##### # # ###
# #   #   #   #   # # # #   # # # # # #   # # # # # # # # # # # # #     # #     # #   # # # # # # #   #     #   # # # # # #     # # #   #
### ### # # # # ##### # # # # ### # # ##### # # # # # # # # ##### # # # # # ##### # ######### ##### ### # # # # ### ####### # # ### ### #
#   #   # # # # #   # # # # # # # # #     # # # # # # #         # # # # # #     # #         #     #   # # # # #   #     #   # #   #   # #
# # ### # # # # # ### ### ### # # ### # # # # # ### # ##### ##### # ##### # # # # # # ####### # # # ### # # # # ### # # # # ### # # # # #
# # #   # # # #     #   # #     #   # # # # # #   # #     #     # #     # # # # # # #       # # # #   # # # # #   # # # # #   # # # # # #
# # # # # ##### ##### ### # # # # ### # # # # # # # ### # ######### ### ##### ### # # ### ####### # ### ### ############### ########### #
# # # # # #         # #   # # # # # # # # # # # # #   # #         #   #     # #   # #   #       # #   #   #               #         # # #
### # # # # ### # # # ### # # # # # ### ##### ##### # ### ### # ##### ######### ### # ### # # # ### # ### # ############### ####### # ###
#   # # # # #   # # # # # # # # #     #     # #     #   #   # #     #         # #   #   # # # # #   #   # # #           #       # #   # #
# # ##### # ### ### ### # # # ### # ######### # ### ### # ########### # # # ### # # # ### # ####### # ### ### ############# # # # ##### #
# # #     # #     # #     # #   # #         # # #     # #           # # # # #   # # #   # #       # #   #           #   #   # #     # # #
# ### # # # ### # ##### # # # ### # # # # # ### # # # # # ##### # # # ######### # # # ########### ### # ####### ### # ####### ####### # #
# #   # # # #   #     # # # #   # # # # # #   # # # # # #     # # # #         # # # #           # #   #       #   #       # #     #   # #
# ### # # # ### # # # ### ### # # # ### ####### ### # # # ##### # ######### ##### ### ############# # ### ################# ##### ### # #
# #   # # # #   # # #   # # # # # #   #       # #   # # #     # #     #   # # # #   #             # #   #   #                   # #     #
##### # ### ### # # # # ### # # ### ########### ### ##### # # ##### ### ##### # ##### ######### # ### ####### ##### ############### #####
#     # #   #   # # # #   #   #   #           #   #     # # #     #                 #         # #   #             #                    x#
#########################################################################################################################################
