#########################################################################################################################################
#o                                    #         #     # #                                 # # # # #                                     #
# # ####### ########### ########### # # ######### ##### # ### ### # ##### # ### ########### # # # # ####### # ##### ####### # # # #######
# #       #           #           # #         #             #   # #     # #   #                           # #     #       # # # #       #
# # # # # ##### # ##### # ### # # ### ### # ### ### ####### ### # ####### # ### # ####### ### # # # # # ### ##### ########### # # #######
# # # # #     # #     # #   # # #   #   # #       #       #   # # #     # #   # #       #   # # # # # #   #   # #           # # #       #
# # # ##################### ######### # # ### ### ### ##### # ##### ### ##################### # # # # # ### # # ### # # ##### ##### # ###
# # #           # #       #         # # #   #   #   #     # #         # #   #           #   # # # # # #   # #     # # #     #     # #   #
# # ### ### # # # # ##### ####### ### # # # ####### # # # # ### ######### ### ########### ####### ##### ### ##### ### # # # ####### #####
# #   #   # # #         # #     #   # # # #       # # # # # # #         # #         #           #     #   #     #   # # # #       #     #
# # # ### # ### # ### # ### ##### ####### ### ### ### ### # # ####### ### # ####### # ##### ####### # ### ####### ##### ########### #####
# # #   # #   # #   # #         #     #     #   #   # #   #         #             #     # #       # #   # #     #     #         # # #   #
# # # # # ### # # # # ######### # ########################### ##### ####### ### ####### # ################# ######### ######### # ### ###
# # # # #   # # # # #         # #     #                     #     #       #   #       #                       #     #         #         #
# # # # ######### ### ### # # # ####### ##### # # # # ####### # ########### ######### ### # ################# ### ################### # #
# # # #       # #   #   # # # #             # # # # #       # #           #         #   # #       #   #     #             #         # # #
# ### # # # # # # ### # # ##### ##### # ### ### ### ### ### # # ################### # # ##### ### # ### ########### ####### ### ### #####
#   # # # # #   #   # # #     #     # #   #   #   #   #   # # #                   # # #     #   #                 #           #   #     #
# # # # ### # ### # # # # # # ### ##### # # # ### # # ### ########### ####### ### ### # ########### # # # ############# # ### ##### # ###
# # # #   # #   # # # # # # #   #     # # # #   # # #   #   #     # #       #   #   # # # # #     # # # #             # #   #     # #   #
# # ### ### # ### # # # # # # ### # ####### # ### ########### ##### ####### ##### ####### # # ##### # ##### ##### # # ### # # ### # #####
# # #     # #   # # # # # # #   # #       # #   #     #         #         #     # # # #           # #     #     # # #   # # #   # #     #
# ##### ##### ########### ######### ####### ##### ##### ##### ### ######### # ##### # # ################# ##### # ############# # #######
#   #       #       # # #       # #       # #   #           #             # #                           #     # #             # #     # #
# ##### ##### ####### # ####### # ########### ######################### ######### # # # # # ### # # # # # # ##### ### ### # # ######### #
# #         #       #         #           #                           #     #   # # # # # #   # # # # # # #     #   #   # # #           #
### ### # # # # # # # ##### ### # # ### ### ##### ### # # ####### # ######### ##### # ### ### # # ################### # ### ####### #####
#   #   # # # # # #       #   # # #   #         #   # # #       # #               # #   #   # # #   #   # #         # #   #       #     #
# # # # ### # # # # # # # # # # ### ##### # # ### # # # ### # ####### ####### # # # # ##### # ####### ### # ####### ### #################
# # # #   # # # # # # # # # # #   #     # # #   # # # #   # #       #       # # # # #     # #             # #     #   #             # # #
# ### # # ####### ### ### # # ##### # ### # ######### ### ### ##### ####### # # # ### # # ############# ### # ##### ################# # #
# # # # #       #   #   # # #     # #   # #       # #   #   #     #       # # # #   # # #     #       #           #             #       #
# # # # ##### ### # # # ### # # # # # # ### ####### ######### # # ### # ####### # ### ######### ##################### # ######### ### ###
# #   #     # # # # # #   # # # # # # #   #                 # # #   # #       # #   #       # #                     # #   #       # #   #
# # # # ### # # # ### ### ##### ##### # # # # ### ### # ### # # ################# ### ####### # ####### ##### ############# ####### #####
# # # #   # #   #   #   # # # #   # # # # # #   #   # #   # # #   #             #   #                 #     #         #           #   # #
# # # # ##### # # ### ##### # ##### # ####### ### # # # # # ##### # ### ########################### ### ######### # ### ##### ##### ### #
# # # #     # # # #               # #   #   #   # # # # # #   # #     #             #   #         #   #         # # #       #           #
# # ### # # # # # ### ####### ##### ##### ######### # ######### ############# # ##### ### ##################### ##### ############### ###
# # #   # # # # # #         #     #       #       # # #     # # #           # #                     #         #                     #   #
# # ### # ######### # # ######### # ####### ##### # ### ##### # # ##### # # ####### # ########### ### ####### # # # # # #################
# # #   #         # # #   #     #               # #   # # #           # # #       # # #     #   #           # # # # # #                 #
# ##### ########### # # ### ############### # ######### # # ######### ### # ### ####### ##### ############# ##### ##################### #
#   #           #   # #                   # #                       # # # #   #   # # #                   #     # # # #               # #
# # # # # # ####### ### ### # ### ### # ################# # # ### ##### ####### ### # # ##### # # # # # ### ####### # # ######### # ### #
# # # # # #       # #     # #   #   # #           #     # # #   #             #     #       # # # # # #   #     #   #           # #   # #
# ### # # # # ##### ### ### # ### # # ####### ##### ####### # ##### ################# ### # ### # ### # # ####### ### ######### ### #####
#   # # # # #     #   #   # #   # # #       #           # # #     #   #       #         # #   # #   # # #   # #               #   #   # #
# ### ### # ########### ### # # ### # # # ############### ### # ##### # ####### ####### ####### ############# # ### ##### # # ######### #
#   # #   #       # #     # # #   # # # #                   # #     #                 #       #         # #       # #   # # #         # #
# ### # # # # # # # ##### # # # # # ### ### # # ####### ### ############### ######### ### # ############# # ### ##### ### # # # ### ### #
#   # # # # # # #       # # # # # # #     # # #       #   #               #         #   # #                   #         # # # #   #     #
# # # # # # # ### # ####### ### # ##### # # ### ### ##### # # ####################### ### ### ####### ####### ### ### # ####### # ### # #
# # # # # # #   # #       #   # #     # # #   #   #     # # #                       #   #   #       #       #   #   # #       # #   # # #
# ### # ### ### # # # ### # ### # ##### ####### # ######### # # ### ############# ######### # # # ######### # # # # # ##### # ####### # #
#   # # #     # # # #   # #   # #     #       # #       #   # #   #             #         # # # #         # # # # # #     # #       # # #
# # ##### # ####### # ### # # # # # # # # # # ##### # ### # # # ### # ### ### # # # ##### ### # ##### # # # ### # ####### ##### ### # # #
# #     # # #     # #   # # # # # # # # # # #     # #   # # # #   # #   #   # # # #     #   # #     # # # #   # #       #     #   # # # #
# # # # ### # ### ####### # ### # # # # # ### # # # # # # # # # # ##### ####### # # # ### ### ######### ##### ### ##### # ##### ##### # #
# # # #   #     #       # #   # # # # # #   # # # # # # # # # # #     #       # # # #   # # #         #     # #       # #     #     # # #
# # # # # # # # # # ### ####### # # ##### # # # ### # ####### ### ##### ##### ### # ### # # ##### # # # # ####### # ##### ### ###########
# # # # # # # # # #   #       # # #     # # # #   # #       #   #     #     #   # #   # #       # # # # #     #   #   # #   #           #
# # # # # # # # # # # ### ##### ### # ##### ### ### # # ### # # ##### # # ################# # ##### ############# # ### ### # # ##### ###
# # # # # # # # # # #   #     #   # #     #   #   # # # # # # #     # # #                 # #     #             # #       # # #     #   #
# # # ### # # # # # # ### ##### # # # # ### ### # # # ### ####### # # # # # # ### # # # # # # # # # # # ######### ### # ##### # # # #####
# # #   # # # # # # #   #     # # # # #   #   # # # #           # # # # # # #   # # # # # # # # # # # #         #   # #     # # # #     #
# ### # # # # # # ### ### # # # ### # # ### ### ### # # ### ##### ### # # # # # # # # # # ##### # ### ##### # # # ##### ##### ###########
#   # # # # # # #   #   # # # #   # # #   #   #   # # #   #     #   # # # # # # # # # # #     # #   #     # # # #     #     #           #
# ### # ### # # # # # ### # # # ### # ##### ##### # # # # # # ### # ### ### # ##### # ### ### ############### ### ### # # ######### #####
#   # #   # # # # # #   # # # #   # #     #     # # # # # # #   # #   #   # #     # # #     #               # # #   # # #         #     #
# # # # # ##### # ### # # # ### # ### ##### ### # ### # # # # ### ########### # ##### ### # # # ##### ##### ### ### ### # # # ### ##### #
# # # # # #     #   # # # #   # #   #     #   # # #   # # # #   #           # #     # #   # # #     #     #       #   # # # #   #     # #
# ### # ### ### # ### # ### # ### # # # # ##### ### # # # # # # ##### ####### # ##### # # ### ################### ### # ### ### # # #####
#   # #   # #   #   # #   # #   # # # # #     #   # # # # # # #     #       # #     # # #   #                   #   # # # # # # # #     #
# ####### # # # # ##### # ### ####### # ##### # ##### # # ##### # # ### # ### # ######### ### # # ##### # # # # ######### ### ###########
#       # # # # #     # #   #       # #     # #     # # #     # # #   # #   # #       #     # # #     # # # # #                         #
# # ##### # # # # # ### ### ##### ### # ### # # # ### # ### ####### ######### # ####### # # ########### ### # # ##### ### # # # # # #####
# #     # # # # # #   #   #     #   # #   # # # #   # #   #       #         # #       # # #           #   # # #     #   # # # # # #     #
# # # # ##### # # # ### # ####### # ############# # ### # # # ############# # # # # ### # # # ### ##### # # # ##### # # # # # # ### # ###
# # # #   #   # # #   # #       # #             # # #   # # #             # # # # #   # # # #   #   #   # # #     # # # # # # #   # #   #
# # # # ##### ### # # # # # ##### ### # # # ### ####### # # ################# ### # ### # # # # # ##### ####### # # # # ### # ##### # ###
# # # #   #     # # # # # #   #     # # # #   #     #   # #                 #   # #   # # # # # #   # #       # # # # #   # #     # #   #
# ##### # # # # # # # ### # ##### # ### # ##### # # # # ### # ### ### ####### ##### # ##### # ### ### # # ### ##### ####### # # ### # ###
#     # # # # # # # #   # #     # #   # #     # # # # #   # #   #   #       #     # #     # #   #     # #   #     #       # # #   # #   #
# # # # # ### # # # # # # # # # # # ### ### ##### ##### ##### ### # # ### # # ### ##### ######### # # # # # # ##### # ### # # # #########
# # # # # #   # # # # # # # # # # #   #   #     # #         #   # # #   # # #   #     #         # # # # # # #     # #   # # # #       # #
# ### ### # # # ### # # # # # # ### ### ### ##### ### # # # ### # ### ### # # ############# # ### # # ##### ### ##### # ### ### ####### #
#   # #   # # #   # # # # # # #   #   # # #     # #   # # #   # #   #   # # #             # #   # # #     #   #     # #   #   #     #   #
# # # ### ### # ### # # ### ### # # # # # # ####### # # # ### # ##### ######### ########### ####### ######### # # # ### # ##### ##### ###
# # # #   #   #   # # #   #   # # # # # # #       # # # #   # #     #       # #           #     # #         # # # #   # #   # #         #
# # # ### # # # # # # ##### # # # # # # # ########### # ######### ### # ##### ##### # ### ####### ############# # ##### ##### ###########
# # #   # # # # # # #   #   # # # # # #           #   #   #     #   # #           # #   #       # #           # #     #               # #
# # # ### # # # ### # ### # # # # # # # # ### # # ##### ### ### ##### ### # ### ### # # ######### # ########### ### ### ### # # ####### #
# # #   # # # #   # #   # # # # # # # # #   # # # #           #     # # # #   #   # # #                       #   #   #   # # #         #
### # ### ### # # # # # # ##### # ### # # # # # ##### # # ######### # # ### # # # ##### # ##### # # ##### ### ### ##### ##### ###########
#   # #     # # # # # # #     # # # # # # # # #     # # #         # #     # # # #     # #     # # #     #   #   #     # #   #           #
### # # # # # ### # # # # ### # # # # ### ### ########### ##### # # # ##### # ### # # ### # ### # # # ### # ### # ####### ####### ### # #
#   # # # # #   # # # # #   # # # #   #     #       #         # # # #     # #   # # # # # #   # # # #   # #   # #               #   # # #
# # # # # # # # ### # # # # ### # # ##### # # ##### ##### ### ### # ####### ####### ### # ##### # # # ############# ### ######### ### # #
# # # # # # # #   # # # # #   # # # #     # #     #   #     #   # #       #       #     #     # # # #     # # #   #   #         #   # # #
# # # # ### ### # ### ### ### ### ### # # ### ######### # ### ### ##### ##### # ##### # # ##### # # # # ### # # ########### ####### ### #
# # # # #     # #   # #     #   # #   # #   #         # #   # # #     #     # #     # # #     # # # # #                   #       # #   #
### ### ### ### ####### # # ##### # ### # # # ### ##### # # # # # # # ########### # ##### ### ##### # # ##### # # # # ############### # #
#     #   # # #       # # #     # # #   # # #   #     # # # #   # # #           # #     #   #     # # #     # # # # #               # # #
# # # # ### # # ### ### ### ### # ### # # ### ### # ##### ####### ##### # # ### # # # ### # # ##### # # # ### ######### # ########### # #
# # # #   #   #   #   #   #   # # #   # #   #   # # #           #     # # #   # # # #   # # #     # # # #   #         # #           # # #
# # # # ### # # ##### # # # # # # # # # # # # # # # ### # ### ######### # # ##### # # # ### # ### # # # # ####### # # ### # ### # ##### #
# # # #   # # #     # # # # # # # # # # # # # # # # #   #   #         # # #     # # # #   # #   # # # # #       # # #   # #   # #     # #
# # # # ##### # ##### # ##### # # # # ####### # # # # # # # # ### # ### # # # # ##### # ### ####### # ### # # # # ### # ### # ##### #####
# # # # # #   #     # #     # # # # #   #     # # # # # # # #   # #   # # # # #   # # #   #       # #   # # # # #   # #   # #     #     #
# # # ### # # # ### # ### # # # # ### ##### # # # ### ### # ### # ########### ##### ##### # ##### # # # # # # # # # ##### ##### ### # # #
# # #     # # #   # #   # # # # # #   #     # # #   # #   #   # #           #           # #     # # # # # # # # # #     #     #   # # # #
# ### ### ### # ####### # ########### # # # ### ### # ### # # ### ### ### # # # ##### # ### ##### ### # ### # # # ### ####### ### ### # #
# #     # #   #       # # # #       # # # # #     # # #   # #   #   #   # # # #     # #   #   # #   # #   # # # #   #       # # #   # # #
# ### # # ### # # ##### ### # ### ##### # ### # ### # # # # # ### ### # # # # ##### # ##### ### ##### ### # ####### # ### # ### ### ### #
# # # # # #   # #     #         #   #   #   # #   # # # # # #   #   # # # # #     # #   #           #   # #       # #   # #       #   # #
# # # # # # # # # # ### ### ### ### ##### ### # ##### # # # # # # ######### # ##### # ### # # # # # # ### # # # ### # ### # # # ### # # #
# #   # # # # # # #   #   #   #   # #       # #     # # # # # # #         # #     # #   # # # # # # #   # # # #   # #   # # # #   # # # #
# ### # ##### # ### # # # # # # # # # # # ### # ### # # ### # # # # ### ### ########### # # # ### ### # # ##### ### # # # # # # # ### # #
# #   # #     #   # # # # # # # # # # # #   # #   # # # #   # # # #   #   #           # # # #   #   # # #   #     # # # # # # # #   # # #
### # ####### ##### # # # # # # # # # # # ### # # # # # ### ### ### # ####### # # ### ### # ####### # # # # ### ##### ########### # # # #
#   #     #       # # # # # # # # # # # #   # # # # # #   #   #   # #       # # #   #   # #       # # # # #   #     #           # # # # #
### # # ### # # ### ### ### # ### # # ### # ### ### # # # # # # # # # # ### ### ### ##### # # # ### ### # ### # ##### ##### ### ####### #
#   # #   # # #   #   #   # #   # # # #   # # #   # # # # # # # # # # #   #   #   #     # # # #   #   # #   # #   # #     #   #       # #
# # # # ### ### ####### # ### ### # ####### # # # ### # # # # # # ### ### # # ##### ##### # ### # # # ### ##### ### # ### ### # ####### #
# # # #   # #         # #   #   # # #         # #   # # # # # # # #     # # #     #     # #   # # # #   #     # #   #   #   # #       # #
# # # # # # # # # # # # ### ##### # ### # # # ### # # # # # # # # ### ### ### ##### ##### # # ######### # ##### # ####### # ### # ### # #
# # # # # # # # # # # #   #     # # # # # # #   # # # # # # # # # #     #   #     #   # # # #         # #   #           # # # # #   # # #
### # # # # # # ### ### ########### # # # # ### # ### # # ##### ##### # # ### # # ### # # # # ########### # # # ### # # ##### # ### # # #
#   # # # # # # # #   #         # # #   # #   # #   # # # # #       # # #   # # #   # # # # #   #       # # # #   # # #       #   # # # #
# # # # # # # # # # ### # # ##### ####### # # ### # # # # # ### ##### ### # # # # ##### ####### # ####### ##### ### ############# #######
# # # # # # # # #     # # #             # # #   # # # # #   #       #   # # # # #             #         # #   #   #             #   # # #
# # # ##### # ### # # # ##################### ####### # # # # # # ### ### ##### # # ########### # ######### ### # # ####### # ####### # #
# # # #     #   # # # #           #         #     #   # # # # # #   #   #     # # #           # #             # # #       # #         # #
# # ### ##### ### # # # ########### ### ##### # # ### ##### # # # # # # # ##### ####### ##### ######### # ##### ##### ################# #
# #   # #       # # # #               #     # # #   #   #   # # # # # # #     #       #     #         # #     #     #                  x#
#########################################################################################################################################
