#########################################################################################################################################
#o                        #                 #       # #                             #                 # #                 #             #
# ##### ### ### # ##### ### ##### ### ### ### ####### # ####### ####### ########### # ### ##### ##### # # ############# ### ########### #
#     #   #   # #     # #       #   # # #           # #       #       #           #   # #     #     #                 #               # #
# ####### ########### ### ######### # # ### ##### ### # ######### ##### # ############# ####### ############### ########### # ### # # ###
#       #           #             # #     #     #               #     # #   # #     #         #           #   #   #       # #   # # #   #
# ### # ##### # # # ####### # ### # ##### ### ########### ################### # ##### ############### ##### ####### ##### ##### ##### ###
#   # #     # # # #       # #   # #     #   #           # #     # # # # #                           #   # #             #     # #   #   #
# # ##### # ### ### # ########### # # ##### ############### ##### # # # # ######### # ######### # # ##### # ### ##### ######### # ### ###
# #     # #   #   # #       #   # # #     # #       #     #     #                 # #     #   # # # #         # #   #       # #     #   #
# # ### ##### # ############# ########### ### ####### ### # ##### ####### ######### # # # # ####### # ########### ########### ###########
# #   #     # #             #       #   #               # #   #         #         # # # #         # #               #     #             #
# ### ### # # ### # ##### # # ####### ####### # ##### ##### ### ### # # ##### # # ### # # # # ####### ############# # ##### ####### #####
#   #   # # #   # #     # # #   #           # #     #             # # #     # # #   # # # # #                     #     #   #     #     #
# ####### # # ####### ####### ### ##### # # ### # ##### ######### ### ##### ##### ######### ### ### ### # ### ######### # ### ###########
#     # # # #       #           #     # # #   # # #   #         #   #     #     #       #     #   #   # #   #         #           #     #
# # ### # ### # ### ########### # ### ##### # ##### ################### ####### # # ########### ##### # # ### # ### ### ####### ### #####
# #     #   # #   #           #     #     # #                         #       # # #           #     # # #   # #   #   #       #         #
# # ### # # ### # # ######### ####### ############### ##### # # ########################### ########### ######### ### # # ######### # ###
# #   # # #   # # #       # #       #               #     # # #             #             #       #   #         #   # # #         # # # #
### ##### ### # # # # ##### ### ##### ### # ##### ### # ### # # # ######### # ####### ####### # ### ############# ##### # # # # # # # # #
#       #   # # # # #         #     #   # #     #   # #   # # # #         # #       #     # # #                 #     # # # # # # # #   #
# # # # # ##### # # # ####### ##### # # ### # ################# # ####### ### ########### # ############# # # ########### # ### # # # ###
# # # # #     # # # #       # #   # # #   # #                 # #       #               #               # # #           # #   # # # #   #
### # ##### ######### ##### ### ################# ##### ### # # # ######### ### # # # ### # ### # ### ##### ######### # # # ### # # ### #
#   #     #     #   #     #                     #     #   # # # #         #   # # # #   # #   # #   #     #         # # # #   # # #   # #
# # ### # # # ### ### # ### ####### ### ############# ### ####### # ######### # # ######### ### # # ### ### # # # ### ### # ##### # # # #
# #   # # # #       # #   #       #   #       #     #   #       # #         # # # #       #   # # #   #   # # # #   #   # #     # # # # #
### ##### ### # # ### ### # # # # # ### # ##### ############# # ######### ######### ####### ##### # ### # # # # # ######### # # # # #####
#       # #   # #   #   # # # # # #   # #     #             # #         #                 #     # #   # # # # # #         # # # # #     #
### ### # # # # # # # ### ### # ### # # # # ### ### # ### ##### # ##### ####### # ### # # # # # # ########### ### # ### # ### # #########
#     # # # # # # # #   #   # #   # # # # #       # #   #     # #     # #     # #   # # # # # # #           #   # # # # #   # #         #
### ### # ### # # ### # ######### ####### ### # # # # ### ##### ##### ### ### ### # # # # # ### ######### # # ##### # ####### ### ### ###
#     # # #   # #   # #         #       #   # # # # #   #     #     #       #   # # # # # #   #         # # #     #         #   #   # # #
# # # ##### # # # ### # # ##### # # # ### # ### # ### ##### ##### ######### ### ### ##### # ############# ### ### # # # # ### # ### # # #
# # #   #   # # #   # # #     # # # #   # #   # #   #     #     #         #   #   #     # #             #   #   # # # # #   # #   # #   #
# # # # ### ### # # # ### # ####### # ##### ##### ### # ##### # ### # # ##### ########### ##### ########### # # # # ### # ### # ##### ###
# # # #   #   # # # #   # #       # #     #   # #   # #     # #   # # #     #   # #     #     #           # # # # #   # #   # #     #   #
# ### # ### ### # ### # ### # # # ### ##### # # ### # ################### ### # # # ####### # # # ######### ### # # # ### ##### ### # ###
# #   #   #   # #   # #   # # # #   #     # #     # #               #   #   # #           # # # #         #   # # # #   #     #   # #   #
# ### ##### ### # # # ### # ### # # ####### # # # # # # # # ######### ### ####### # ### # ### # # ### # # # # # # # ##### # ######### # #
# #       #   # # # #   # #   # # #       # # # # # # # # #             #       # #   # #   # # #   # # # # # # # #     # #         # # #
# # # # # # # # ##### # # # ### # # # ### # ### # # # # # # ############# ####### # # ##### # ### # ### ### # ##### # ################# #
# # # # # # # #     # # # #   # # # #   # # # # # # # # # #             #       # # #     # #   # #   #   # #     # #       #         # #
# ### # ### # # ####### # # ####### # # ### # ######### ##### # # # ### ### ### # # # # ######### # ### # ### # # # # ####### ####### ###
# #   #   # # #       # # #       # # #   #         #       # # # #   #   #   # # # # #         # #   # #   # # # # #             # #   #
# ### ### # # # # # ### # # # # # ####### # # ##### # # ### ### ### # ##### ##### # ### # ### ### # # ##### # ######### # # ### ### #####
#   #   # # # # # #   # # # # # #       # # #     # # #   #   #   # #   # #     # #   # #   #   # # #     # #   #     # # #   #         #
# ### ##### # # ### ##### # ### ### # # ### # ####### # # ##### # # # # # ##### # ### ########### ### ########### ### # # ####### # # # #
#   #     # # #   #     # #   #   # # #   # #       # # #   # # # # # #       # #   #           #   #     #         # # #       # # # # #
# ### # ### # # ##### # # # ### # # # ##### # ####### # # ### # ### # # ### ##### # ##### ##### # ########### ### # # ##### ### # # # # #
#   # #   # # #     # # # #   # # # #     # #       # # #     #   # # #   #     # #     #     # #               # # #     #   # # # # # #
# # # # # ##### ### # # ### ####### # # # # # # # ### ### ####### # # # # ### # ### ####### # ####### ### ######### ### ### # ### # #####
# # # # # #       # # # # #       # # # # # # # #   #   #       # # # # #   # #   #       # #       #   #         #   # #   # #   #   # #
# # # # ##### # # # # # # ##### # ### ### # ##### # # ### # # # ##### ### ################# ################# # ##### ####### ### # ### #
# # # #   #   # # # # #       # #   #   # #   #   # #   # # # #     #   #                 #                 # #     #       # #   #     #
# # # # ### # # ##### # # ##### # ### ### # ######### ##### # ### # # ### ### ##### # # # # ### ######### ### ####### ### # ####### # ###
# # # # #   # #   #   # #     # #   #   # # #       #     # #   # # #   #   #     # # # # #   #         #   #     # #   # # #     # #   #
# ##### # # # # # # # # # # ####### # ### # # ##### ####### ############# ##### # # ### # ### ######### ####### # # ### # ### ##### ### #
#     # # # # # # # # # # #       # #   # #       #       #             #     # # #   # #   #         #       # #     # # # #     #   # #
# # # # ### # # # ### # # # ######### # ### # # ################# ### ### # # # # # ##### # ### ################### ####### # ####### ###
# # # # #   # # # #   # # #       # # # #   # #                 #   #   # # # # # #     # #   #                   #               # #   #
# ##### ### # # # ### # # # ####### ####### ### # # # # # ##### ########### # ##### # ### ######### # ##### ####### ####### ### # # #####
#     # #   # # # #   # # #             #     # # # # # #     #           # #     # #   #         # #     #       #       #   # #       #
# # # ##### # # # ### # ### # ### ######### ### ### ############# ####### # # ########### ####### ### # ### # ### ##### # ### # ####### #
# # #   # # # # # #   #   # #   #         #   #   #             #       # # # # # #     #       #   # #   # #   #     # #   # #       # #
# # # ### # # # # ### # # # # # # ##### ### # # # # # # ##### # ############### # # ##### # ######### ### ########### # # # # ### # # ###
# # #     # # # #   # # # # # # #     #   # # # # # # #     # #                   #     # #         #   #           # # # # #   # # #   #
# # # # # # # # # ### # ### ##### # # ### # # ### ##### ####### ##### ##### ####### ##### # ### # ####### ##### # # # # ##### ### ### ###
# # # # # # # # # #   # #       # # #   # # # #       #       #   # #     #             # #   # #       #     # # # # #   #     #   #   #
# ### ####### # ### # ### # # ####### ##### # # # # # # ### # ##### ############### # # # # # ### ######### # # ####### ##### ### # # # #
# #         # #   # #   # # #       #     # # # # # # #   # #             #       # # # # # #   #         # # #       #     #   # # # # #
# # # # ##### # # ### # # # # # # ### # ### ### ### # # # # ### # # ### ### ##### # # # # ### ### ### ### # # ######### # # # ### ### ###
# # # #     # # # #   # # # # # #   # #   #   #   # # # # #   # # #   #         # # # # #   #   #   #   # # #         # # # #   #   #   #
# # ### ####### ### # # ### ### # # ### # # ####### # # # # ######### ####### ############### ### ### ####### # ### ### # ### ### ### ###
# #   #     #     # # #   # #   # #   # # #       # # # # #         #       #     #         #   #   #       # #   #   # #   #   #   #   #
# # ### ##### # # # ### # # ### # # # # # ### # # ### # ### ### # ### # ####### ### ############# ### # ##### ### ##### ### # ##### # ###
# #   #     # # # # #   # #   # # # # # #   # # #   # #   #   # #   # #       #                 #   # #     #   #     #   # #   # # #   #
# # ### ##### # ### # # # # # # ##### ### ### # # # ### # # ### # # # ### # # ##### # # ### ### ### ### ##### ##### ##### # ### # #######
# #   #     # #   # # # # # # #     #   #   # # # #   # # #   # # # #   # # #     # # #   #   #   #   #     #     #     # #   #         #
# # ### # # # # # # # # # # # # # ####### ### ####### # # # ### # # ####### ### ### ############### # ### # ####### ### ### # ####### ###
# # #   # # # # # # # # # # # # #       #   #       # # # #   # # #       #   #   #               # #   # #       #   #   # #       #   #
# ##### # # # # # ### ### # # # # ######### # # ### # ### # # # ### # ########### ### ### ##### ### # ####### ##### ### # # # # # # # # #
#     # # # # # #   #   # # # # #         # # #   # #   # # # # # # #           #   #   #     #   # #       #   # #   # # # # # # # # # #
# # ### # ### ### ### # # # # # # ##### ### # ##### # ### ### # # # # # ######### ### # # # ####### # ### # ##### ####### # # # # # ### #
# #   # #   #   #   # # # # # # #     #   # #     # #   #   # #   # # #         #   # # # #       # #   # #   #         # # # # # #   # #
# # # # # ### # # ### ### ### # # # ### ### # # # # ##### # # # ### # # # ### # # ##### ### # # # ### ##### ### ##### ##### ### # ### ###
# # # # #   # # # #   #     # # # #   #   # # # # #     # # # #   # # # #   # # #     #   # # # #   #     #         # #   # # # #   #   #
# ### # # # # ### ### # # ### # # # # ##### # ######### # # # # # ### # # # # # # ##### ##### ##### # ### ### # ####### ##### ### # # ###
#   # # # # #   # #   # #   # # # # #   # # #         # # # # # #   # # # # # # #     #     #     # #   #   # #           #     # # #   #
# # ### # ### # # # # ### # # # # ### ### # # ############# # # # # # # # ####### ### # # ### ### ### # ### # # ### ####### ##### # # # #
# #   # #   # # # # #   # # # # #   #     # #             # # # # # # # #       #   # # #   #   #   # #   # # #   #             # # # # #
### # ### # # # # # # # # ### ### ### ####### # ### # ### # # # # # # # ### ######### ####### ####### ### ##### # ### # # # # # ### ### #
#   # #   # # # # # # # # #     #   #       # #   # #   # # # # # # # #   #         # # #   #       #   #     # #   # # # # # #   # #   #
### ### # # # ### # # # # ### # # # # ####### # # ### ### # # # # # # # # # # # ### ### # ################### # # # # # # ### ##### # # #
#     # # # # #   # # # #   # # # # #       # # #   #   # # # # # # # # # # # #   #                         # # # # # # #   #     # # # #
### ### # ### ### # # # # ### # # ### ### ### # # ### ### ### # ### # # ##### ### # ##### ### # ##### ### # # # # ### ### # # ##### ### #
#     # #   # #   # # # #   # # # #     #   # # #   #   # #   # #   # #     #   # #     # # # #     #   # # # # #   #   # # #     #   # #
### # # # ### # # # ##### ##### ##### ####### # # # # # ### # # # # # # # # # # ### # # ### ############# ### # # # ##### # # ####### # #
#   # # #   # # # # #       #       #       # # # # # # #   # # # # # # # # # #   # # #                 #   # # # #     # # #       # # #
# # # # # ### # ### # ### # ### # ### # ### # ### ##### ### # ##### # # ### # # ######### ##### ######### ##### # ### ##### # ###########
# # # # #   # # #   # #   # #   # #   #   # #   #     #   # #     # # #   # # #         #     #         #     # #   #   #   #         # #
# # ### # # ##### # # # # # # # # ### ########### # # ##### ### # # # # # # # # # ### # # # ### ################# # ####### # ##### ### #
# # #   # #     # # # # # # # # # #       # #   # # # # # #   # # # # # # # # # #   # # # #   #                 # #     # # #     #     #
# # ##### # ##### # ##### # ### ### # # ### # ### # ### # ### ####### # # # # # # ### # # # ### # ##### ##### # # ### ### # ### # #######
# # #     #     # # #     #   # #   # #         # #         #       # # # # # # # # # # # #   # #     #     # # #   # #   #   # #     # #
### # # # # ### # # # ### ######### # # # ##### ### # ### ### ##### # # # # # # # # ####### # # ### # # ############### ############### #
#   # # # #   # # # # #       #     # # #     #   # #   #   #     # # # # # # # #         # # #   # # #           #             #     # #
# # ### # # # ### # # # # # # # ### ### ##### ### # ### ##### # ##### # ### # ### ### ##### ### # # ##### ##### ### ############# ##### #
# # #   # # #   # # # # # # # # #     #     #   # #   #     # #     # #   # # #     #     #   # # # #   #     #                 # #     #
# # ### ### # ### # ### # # # ### # ### # # ##### # # ### # # # # # ##### ### ### # ### ####### # ### ### ####### # # ### ####### # #####
# #   # #   #   # #   # # # # #   # #   # #     # # #   # # # # # #     # #     # #   #       # #       #       # # #   #   #           #
### ### # # # ##### # # # # # ### ### # # # # # # # # # ##### # # ########### ### ### # ### # # ##### ### ### ### # # ####### ####### ###
#   #   # # #     # # # # # # #     # # # # # # # # # #     # # #           # #     # #   # # #     #   #   #   # # #               #   #
# # ### ### # # # # # # # # ### # ##### # # ####### # ############# ### # ### # # # # # # # ### # # ### ################# ##### # #######
# #   # #   # # # # # # # # #   #   #   # #       # #             #   # # #   # # # # # # #   # # #   #           # #   #     # #       #
# # # ### # # # # # # # # ### # # # ### # ######### # # # ######### ####### # ### ### ### # # # # # ### ##### ##### # ################# #
# # # #   # # # # # # # # #   # # # #   #         # # # #         #       # # #     #   # # # # # #   #     #                         # #
# # # # # # # # # # # # ##### ### # ### # # ####### # # # ########### ####### # # ######### # # # # # # ##### ######### ####### # ### ###
# # # # # # # # # # # #   #   #   # #   # #       # # # #       #   #     # # # # #       # # # # # # #     #         #       # #   #   #
# # ### # ### # # # # # # ### ### # ### # # ### ##### # # ### # # ######### ##### # ### ### ##### # ######### # # # # ### ### ### ### ###
# # #   #   # # # # # # # #   #   # #   # #   #     # # #   # #               #       #   #     # #         # # # # #   #   #   #   #   #
# # # # # # # # # # ### ### # # # # # # # # ######### # # # ### ### ####### ### # # # ##### ####### # ##### # # # # # # # # # ####### # #
# # # # # # # # # # #     # # # # # # # # #         # # # #   #   #       #   # # # #   # #       # #     # # # # # # # # # # #     # # #
# ##### # ### # # ##### ### ### # # ##### # # # # ##### # # ##### ########### ##### # ### ######### # # ####### # # # # # ### # ##### ###
# #     #   # # #   #   #     # # #   #   # # # #     # # #     #           #   #   #             # # # #   # # # # # # #   #       #   #
# ##### # # ### # # # # # # ####### # # # ### # ### ####### # ### # ################# ##### ### ### # # # ### ####### # # ### # ### #####
# #     # # #   # # # # # # #       # # #   # #   #       # #   # #               #       #   #   # # #             # # #   # #   #     #
# ### # ### # # # ### # ### # ##### ### # ##### # # # # ### # ####### # ### ####### # # ##### # ### ### ### ### ####### # ### # #########
# #   #   # # # #   # # #   # #       # #     # # # # #   # #       # #   #       # # #     # #   #   #   #   #       # #   # # #     # #
### # # # ### ### # # # ####### ### ### # # ##### # ### # # # # ### # ##### ####### # # # # ####### # # ##### ####### ######### # ##### #
#   # # #   #   # # # # #       #     # # #     # #   # # # # #   # # # # #       # # # # #       # # #     #       #         #         #
### # # # ### ### # # # ##### ### # # ### # # ### # ####### # # # ##### # ########### ### # # # ### ### ##### ############### # # # #####
#   # # #   #   # # # # # # # #   # #   # # #   # #       # # # #                   #   # # # #   #   #     #               # # # #     #
# # ##### ####### ##### # # ####### ##### # # ### # ####### # ################# ##### ####### ##### ### ################### # ### # #####
# #   #         #     # #               # # #   # #       # #                 #     #       #     #   #                   # #   # #    x#
#########################################################################################################################################
