#########################################################################################################################################
#o                    #     #       # #                   # # #               #                 #   #     #   #       # #             # #
# # ################### ##### ####### # ##### ############# # # ############# # ################# ### ##### ### ####### # ####### ##### #
# #             # #         #               #         # # #                 # # # #   #       #   #       #     #       # #     # #     #
# # # # # ### ### # ######### ##### ##### ############# # # ################### # # ### ####### ### ### ### ##### ### ### # ####### #####
# # # # #   #                     #     #                     #                                   #   # # #         #     #             #
# # ### # ### ####### ### ##### ### ############### ########### ######### ############### ######### ##### # ### ### ####### ### ##### ###
# #   # #   #   #   #   #     #   #               # # # # #             #   #         # # #     #             #   #       # # #     #   #
# # # # # # # # # ##### ### # # # ####### # ######### # # # ####### ### ##### ######### ### ##### ##### # ##### ########### # ##### ### #
# # # # # # # #     # #   # # # #       # #                       #   #                               # # # # #                   #   # #
# # ### # ### ####### ### ##### # # ### # ####################### ################# # # ####### # ######### # ########### # # ###########
# #   # #   #           #   # # # #   # #       #               #   #   #         # # #       # #       # #   #   #     # # #           #
### ##### ##### ####### ##### ##### ######### # # ######### # ####### ### ########### ### # ############# # ### ### ##### # # # #########
#     #       #     # #   #       #         # #           # #                 # #   #   # #     # # #                   # # # #         #
# # ### # # ####### # ##### ########### ########### ### # ##### ############# # # ### ##### ##### # # ####### ####### ### # ### #########
# #   # # #       #       # #         #           #   # # # # # #       # # #       #     #                 #       #   # #   #         #
### # # # # ### # ####### # # ##### ####### # # ##### ##### # ### ####### # ############# # ########### # # ##### # ####### ### ### ### #
#   # # # #   # #       #         # #     # # #     #                                   # #           # # #     # #       #   #   #   # #
# # # ### # ##### # # ### # ######### ####### ### ### ##### ### # ########### ############# ####### ######### ##### ##### ######### #####
# # #   # #     # # #   # #                 #   #   #     #   # #           #         #   # #     #         #     #     #         #     #
### ### # # ### ### # ### # # ##### ############# ### # ####### ######### # ### # ##### ##### ############# ### ##### # ### ### ### ### #
#     # # #   # #   #   # # #     #             #   # #       #         # #   # #   # #                   #   #     # #   #   #   #   # #
# # # # ### ### # # # # # # # ##### # # ### # ####### # # # # # ####### ####### ### # # ####### # ################### ####### # # # #####
# # # # #     # # # # # # # #     # # #   # #       # # # # # #       #       # # # #         # #   #   #           #       # # # #     #
# # # ### # ### ### # ### # # # ### # # # # # ### # # # # # # # # # # ### ####### ### ##### ### ##### ### ####### ### ##### ##### # #####
# # #   # #   #   # #   # # # #   # # # # # #   # # # # # # # # # # #   #                 #   #   #             #   #     # #   # #     #
# # # # # # ### ### # ##### # # ##### # # # ##### ####### ####### # # # ########### ### ##### # ### ####### ####### # # # # # ##### #####
# # # # # # # #   # #     # # #     # # # #     #       #     # # # # #           #   #     # #           #       # # # # # #     #     #
# # # # # # # # ### # # ### ### # ########### ######### ####### ### # # # # # ### ############# ####### # ### ####### ####### ##### # # #
# # # # # #   #   # # # #     # #     #     #         #           # # # # # #   #     #       #       # #   #       #       #   # # # # #
# # ### # ##### # # # ### # # # # ##### ######### # ################# ####### ##### ### ##### ######### # # ################# ### #######
# # # # #     # # # #   # # # # #   #           # #                 #       #     #         #         # # #       # #   #   #           #
# ### ####### # # # # ##### # ### ### ### ######### ### ### ####### # # ### # ##### ##### # # ### ### # # ### ##### # ### ### ####### ###
#           # # # # #     # #   #       #         #   #   #       # # #   # #   # #     # # #   #   # # #   #   # #                 #   #
# # # # # ### # ##### # # # ### # ### # ### # # ####### # ##### ##### ### ####### ### # ##### # ################# # ### ######### #######
# # # # #   # # #     # # #   # #   # #   # # #       # #     #     #   #           # #     # #                       #         #     # #
# # ### # ### ####### ##### ##### ### # ### ### # ##### ### ### # ### # ##### # ##### # # ####### ### # ##### ##### # # ############### #
# #   # #   #   #         #     #   # #   #   # #     #   #   # #   # #     # #     # # #       #   # #     #     # # #         #   # # #
# # ### # # ##### ### # # # ##### ### ####### # ##### # ### # # # # ### # # # ##### # ################# # ### # ##### # ##### # # ### # #
# #   # # #     # #   # # #     #   #       # #     # #   # # # # # #   # # #     # # #               # #   # #     # #     # #         #
# # # # ### ##### ### # ### ##### ##### ### ### # # ### # # ##### ##### # ##### ##### # ##### # # ### ##### # # # ##### # ### # # # # ###
# # # #   #   #   #   #   #     #     #   #   # # #   # # #   #     # # #     #     #       # # #   #     # # # #     # #   # # # # #   #
### ### ### ##### ### # ### # ########### ##### # # # # ### ### # # # # # # ### # ##### # # # # ### # ##### ##### ### ######### ### # # #
#     #   #   #     # #   # #           #     # # # # #   #   # # #   # # #   # #     # # # # #   # #     #     #   #         #   # # # #
# # ### # # ### # ### # # # # ### ### ### # # ### # ### ### # ######### # # ##### ##### ##### ##### # # ### # # # # ####### ##### ### ###
# #   # # #   # # #   # # # #   #   #   # # #   # #   #   # # #       # # #   #       #     #     # # #   # # # # #       #     #   #   #
### ### # # ##### # # # # ##### ##### ### ### ##### ### ####### ####### # ##### # # # # # # # ### ##### ####### # # # # ##### ####### ###
#     # # #   #   # # # #     #     # # # #       #   #         #     # #     # # # # # # # #   #     #     # # # # # #     #     # # # #
# # # # ### ### # ### # ### ### ####### ##### # # ##### # ####### ######### ##### # # # # # # ####### # # # # ### # # # # ##### # # # # #
# # # #   # #   # #   #   #   #             # # # #   # #                 #     # # # # # # #       # # # #     # # # # #     # #   #   #
# # # # ### ### ### # # ### # # ##### ### # ### ### ### # ### # ### ##### # ########### ### # # # ############### # # # # # # ####### ###
# # # #   # #     # # #   # # #     #   # #   # #     # #   # #   #     # #   #       #   # # # #               # # # # # # #       #   #
# ### # # # # # ##### # # # ######### ### # ##### ##### # ### # # # ### # # # # ########### # # # ### # ########### # ##### #############
#   # # # # # #   #   # # #         #   # #     # #   # #   # # # #   # # # #             # # # #   # #           # #     #             #
# ##### ### # # ##### # # # # # # # ######### ### # ######### # # # ############# # # # # # ### # ### # ##### # ####### # # # # # #######
#     #   # # #   #   # # # # # # #     # # #               # # # #             # # # # # # #   #   # #     # # #     # # # # # #     # #
# ######### # # # # # # ### # # ##### # # # ### ### ### # ### ### ##### # ##### ####### ### # # # # # # # # ### # ##### # ### # # ### # #
#         # # # # # # #   # # #     # #       #   #   # #   # #       # #     #       #   # # # # # # # # #   #       # #   # # #   #   #
# # # # ##### ### # # # # # # # ##### # # # # ### ########### # # # # # # # # ############# # # # # ### # ### ######### # ### ###########
# # # #     # #   # # # # # # #     # # # # #   #           # # # # # # # # #             # # # # #   # #   #         # #   #           #
# ##### ### # ### # ### # # # # ####### # # ##### # ##### ### # # # ### ### ### ### ##### ### # # ##### # # ####### # # ### # # #########
# # # #   # #   # # #   # # # #       # # #     # #     # #   # # #   #   #   #   #     #   # # #     # # #       # # #   # # #         #
# # # ### # # # # ### # # # # # # ### # # ### # # # # # ### # # # # ##### # ##### # # ######### ##### # # # # # ##### ####### # # # ### #
#       # # # # # #   # # # # # #   # # #   # # # # # #   # # # # #     # #     # # #         #     # # # # # #     #       # # # #   # #
# ### ### # ### ### ### ### ### # ####### # # # # # ### ### ### # # ####### ### # ### # # # ### # ######### # # ##### ####### # # # #####
#   #   # #   # #   #     #   # #       # # # # # #   #   #   # # # # #   #   # #   # # # #   # #         # # #     #       # # # #     #
# # # ### # ### # # # # # ##### ### # ### # # ### # # ############### # ##### # # ################# # ####### ### ####### ### ### # # # #
# # #   # # #   # # # # #     #   # #   # # #   # # #                       # # #       #   #     # #       #   #       #   #   # # # # #
# ### ### # # # ### ### # # # # # ### # # ### ##### # ### # ### ####### # # ### # ##### # ### ##### # # ##### ############### # ### # # #
# # #   # # # # #   #   # # # # #   # # #   #     # #   # # # #       # # #   # #     #   #       # # #     #               # # #   # # #
# # ##### ##### # # ### # ### # # ##### # # # # ### # # ##### ####### ### # # # # # ### ### ############### # ### ######### # ##### ### #
#       #     # # # #   #   # # #     # # # # # # # # #             #   # # # # # #   #                   # #   #         # # #   #   # #
# ### ### ##### ### # # # ### # # # # # # # # ### # # # # # # # ### # # ### # # # # # # # # # ####### ##### # ### ####### ##### ### #####
#   # # #     #   # # # #   # # # # # # # # # #   # # # # # # #   # # #   # # # # # # # # # #       #     # #   #       #         #     #
# # ### ####### # # ### # ######### ### ##### # ##### ##### # # # ### # # ####### # ### # # # # ### # # ### # ##### ### # ######### #####
# #           # # # #   #         #   #   #       #       # # # #   # # #       # #   # # # # #   # # #   # #     #   # #         #     #
# # # ### ### # # ### # # ##### # # # # # # # ### # # # # # ### ### ##### # # # # # # # # # # ##### # ### ### ### # #####################
# # #   #   # # # #   # #     # # # # # # # #   # # # # # #   #   #     # # # # # # # # # # #     # #   #   #   # #                     #
# ##### ####### # # # # # ######### ##### ### # ### # # # # ######### ### # # # ### # # # # # # ##### # ##### ### # #####################
#     #       # # # # # #         #     # #   #   # # # # #         #   # # # #   # # # # # # #     # #     #   # #         #           #
# # ### ##### ##### # # # # ####### ######### ### ### # # ##### # ##### # ##### ### ### # # # # ################# # ######### ###########
# #   #     # #     # # # #     # #     # #     #   # # #     # #     # #   #     #   # # # # #       # # #     # #                     #
# # # ### ### # ### ### # ####### ####### ### ### # ### ######### # # # # # ### ### # # # # # # ##### # # # ####### ##### ### ### ##### #
# # #   #   # # #   #   #       #     #   #     # # #           # # # # # #   #   # # # # # # #     #             #     #   #   #     # #
# # # # # # ### # # ##### # ##### ##### ######### # ### ######### ### ### ### ### # ### # # ### ##### ### # ####### # ##### #############
# # # # # #   # # # # #   #                     # # #           #   #   #   #   # #   # # # #       #   # # #     # #     #             #
### # # # # # ### # # # # # ############# # # ######### # ### ### ### ####### ### ####### ### # # # ### # ### ########### ### ######### #
#   # # # # # #   # #   # #             # # #         # #   #   # #         #   #     #   #   # # #   # #             # #   #   #     # #
# # ### # # ########### # ### # ### ### ### ##### ### # ### # ######### ####### ### # # # # # # # # ##### ##### # ### # ######### ##### #
# #   # # #   # #       #   # #   #   #   #     #   # #   # #         #       #   # # # # # # # # #     #     # #   # #               # #
# # # # # # ### ### # # # # ##### # # ####### ##### ### ############# ##### ### # # # ##### # # ### # # # # # ######### ######### ##### #
# # # # # # #       # # # #     # # # #     #     #   #             #     #   # # # # #     # # # # # # # # #                   #     # #
# # # ##### # # # # # # # # ##### ### # ##### ### # ### # ######### ####################### # # # # # ############# # # ##### ### #######
# # #   #   # # # # # # # #   # # #         #   # #   # #         #       #           #     # #   # #             # # #     #   #     # #
# ############# # ######### ### ##### # # ######### ##### # # # # ### ##### ##### ########### # # ### ### ######### # # ### # # ### ### #
#       #       #   #               # # #         #     # # # # #   #           #         #   # #   #   #         # # #   # # #   #     #
# # ######### # # # # # # # ##### ##### ### ### ##### # # # # # # # # # # ############### # # # # ### # # ### ##### ### # ### ##### ### #
# #         # # # # # # # #     #   #     #   #     # # # # # # # # # # #               # # # # #   # # #   #     #   # #   #     #   # #
# # ### # ### # # # ####### # ##### ### ##### ######### ### ### # ### # # # # ### ##### ### # ### # # ### # # ### # # # # # ####### #####
# #   # #   # # # # #       #     #   #   # #         #   #   # #   # # # # #   #     # #   #   # # #   # # #   # # # # # #       #     #
# # ### # # # # # ####### # # # # ####### # ##### ##### ####### # # ### # ### ### ########### ####### ### # # ### # # ##### # ####### ###
# #   # # # # # # #       # # # #       #       #     #       # # #   # #   #   #           #   #       # # #   # # #   #   #       #   #
# ### # # ### # # ####### ### # ### ############# ### # ########### ##### # # ##### # ### # # ##### # ### ### ##### # # ### ### ##### # #
#   # # #   # # # #       #   #   #             #   # #           #     # # #     # #   # # #     # #   #   #   #   # #   #   #     # # #
# ##### # # ### ### # # # ### # # # # ### ### ### # # ### # # # # # ### # ### ##### # ### ### ####### # ##### ##### # # ### # # ### # # #
#     # # #   # #   # # #   # # # # #   #   #   # # #   # # # # # #   # #   #     # #   # #         # #     #     # # # #   # #   # # # #
# ##### # ### ### ####### ### # # # # ### # ### # ##### # ### # # # # # # # # # # # # ####### ### # # ### # ######### # ### # # # # # # #
#     # #   # #   #         # # # # #   # #   # #     # #   # # # # # # # # # # # # #       #   # # #   # #       #   #   # # # # # # # #
# # ### ####### ######### # ### # # # # # ### # ### # # # # # # ### ### # # ########### ##### ### ### # # ### ####### # # ### # # # # # #
# #   #     #   #         #   # # # # # #   # #   # # # # # # #   #   # # #           #     #   #   # # #   #       # # #   # # # # # # #
# ##### ####### ##### # # ### # # # ### ######### ### # # # ### ### # # # # # ### # # ### # # ### ### # # ####### # # ####### # # # # # #
#     #     #   #     # #   # # # # #           #   # # # #   #   # # # # # #   # # #   # # #   #   # # #       # # #       # # # # # # #
# # ### # ### ##### # ### # # ### ### # # ##### ####### # ##### ### # # # # # ##### ### ##### ### # # ### # # # # # # ### ####### # # # #
# #   # #   # #     # #   # #   #   # # #     #       # #     #   # # # # # #     #   #     #   # # #   # # # # # # #   #       # # # # #
### # # # ##### ### ##### # ### ##### # # ### ### ### ### # ### # ##### # # # ##### ##### ### # # # ##### ### ### # # ### # # ### # # # #
#   # # #     # #   #     #   #     # # #   #   #   #   # #   # #     # # # #     #     #   # # # #   #     #   # # #   # # #   # # # # #
# # ### # ####### # # # # # # # # # # ### ##### # # # # # ##### # ### # # # # ##### ### ##### # ### # # # # # # # # # ### ### # # # # # #
# # #   #   #     # # # # # # # # # # #       # # # # # #     # #   # # # # #     #   #     # #   # # # # # # # # # #   #   # # # # # # #
# # # # # # # # # # ### # # # # ##### ### # ### # ### # ##### ### # # # # ### # ### ### # # # # ######### # ### # # # # ##### ####### # #
# # # # # # # # # # #   # # # #     # #   #   # #   # #     #   # # # # # #   #   #   # # # # #         # #   # # # # #     # #       # #
# # # # # ### # # # # # # # # ####### # # # # ##### ##### # ##### ##### # # # ##### ####### # # ##### # ### # ### # # # # # ### ### # # #
# # # # #   # # # # # # # # #     #   # # # #     #     # #     #     # # # #     #       # # #     # #   # #   # # # # # #   # #   # # #
# ### # # # # # ### # ### # # # # ##### # # # # # # ### # ##### # # ##### # # # ### # ##### # # # # ### ######### # # ### ######### # # #
# #   # # # # # #   #   # # # # #     # # # # # # #   # #     # # #     # # # #   # #     # # # # #   #   #   # # # #   #       # # # # #
# # # # # ### # ### # ### ### ### ######### ### ### ####### ##### ####### # # # ############# # # ######### ### ### ### # # ##### # # ###
# # # # #   # # #   # #     #   #         #   #   #       #   # #     # # # # #           #   # #                 #   # # #   #     #   #
# ### # ##### # # ### ### ##### # # # ### ### # # # # ### ### # # ##### ### # # # ### ####### # # # # ### # # ##### # # # # ### ### # # #
# #   #     # # # #   #       # # # #   #   # # # # #   #   #   #         # # # #   #   # #   # # # #   # # #     # # # # #   # #   # # #
# # ### # ### # ### # # # # ### # ######### # ### # # # ##### # ### # ##### ### ### ##### # # ### # # ### # # # # ##### # # ##### # # ###
# # #   #   # # #   # # # #   # #         # #   # # # #     # #   # #     #   #   #       # #   # # #   # # # # #     # # #     # # #   #
# # ### ####### # # # # ### # ### ### ### # # ### ##### ### ########### ####### # # # # ####### # # # # ### ### ### ############### # # #
# # #       #   # # # #   # # # #   #   # # # #       #   #           #     #   # # # #       # # # # #   #   #   #           # # # # # #
# # ### # ### # ##### ##### ### # ##### ##### ### # # # ####### # ######### ### ### # # # # # ### ### # # ### ##### # # ####### # # # ###
# # #   #   # # #         #   #       #     #   # # # #       # #         # # #   # # # # # #   #   # # #   #     # # #       # # # #   #
# # ##### ######### # ### # # ### # ### ######### # ### ##### ######### ### # ### # # # # ##### ##### # ########### ### # ##### # ### # #
# #   #       #     #   # # #   # #   #         # #   #     #         #   #     # # # # #     #     # #           #   # #     #       #x#
#########################################################################################################################################
