#########################################################################################################################################
#o# # #   # #                           #             # #             #   # #   #         #       #             #     #                 #
# # # # ### # ### ######### # # ######### ####### ##### # ######### # # ### # ### ######### ### # # ####### ##### ##### ####### # ### # #
#               #         # # #                 #                 # # #                       # #         #           #       # #   # # #
# # # ### ############# ### ### # # ########### # ####### # # # ####### ### ######### ####### # # ### ####### ######### ####### #########
# # #   #             #   #   # # #   #     # # #       # # # #     #   # # #       #       # # #   #       #         #     # #         #
# ### ### # # ### # ################### ##### ##### ##### # ##### ### ### ### ### # ### ######### ### # # ### ######### ##### ###########
#   #   # # #   # #             # #   # #         #     # #     #               # #   #         #   # # #   #         #               # #
# ### # # # ### # # ############# # ### # ##### ############# # # ### # # ######### ##### ##### ####### # ############# ######### ##### #
# #   # # #   # # #           #               #             # # #   # # #         #     #   # #       # #   #               #   #     # #
# ### # ####### ### ### ##### # ##### ########### # ####### ##### ##### # # # ############### ### ##### ##### ############### ######### #
# #   #       #   #   #     #       #           # #       #     #     # # # #             #     # #   #       # #                   # # #
# # # # # # ######### ######### # ##### ### # ############### ### ### ##### ##### ### # ### ### ### ########### # ########### # # # # # #
# # # # # #         #         # #     #   # #               #   #   #     #     #   # #       # #       #           #       # # # #     #
# # # # # # # ##### # # ####### # ##### ### # # # # ### ####### ####### ### ### ### ######### ### ### ### ### ### ### ### ### # # #######
# # # # # # # #   # # # #     # #     # # # # # # #   #   # # #       #   #   #   #         #       #       #   #       #   # # #       #
# # # ##### ### ######### ####### ### # # ######### ####### # ####### ##### # ####### ############# # # ### ####### # # ##### ### # # # #
# # #     #                     #   # #           #       #       # #     # #       #       # #   # # #   #       # # #     # #   # # # #
# # # # # # # ### ### ### # ### # # # # ####### ####### ### ####### ########### ####### ##### # ##### # ##### # # ### # ### # ######### #
# # # # # # #   #   #   # #   # # # # #       #       #                       #       #   #         # #     # # #   # #   # #         # #
# # # ### # # # # # # # # ####### # # # # ### ########### # # # ####### ################### ####### ### ######### ### # ### ### #########
# # #   # # # # # # # # #       # # # # #   #           # # # #       #               # #         #   #         #   # #   #   #       # #
##### # # # # ### # # ### ### ######### # # ### ##### ##### # # ### # ##### ########### # ### # ####### # ### ####### ######### ##### # #
#     # # # #   # # #   #   #         # # #   #     #     # # #   # #     #                 # #     # # #   # #     #         #   # #   #
# # # # ##### # # # # # # # ### # ####### # ############# ### ######### # # ############### ######### ##### ### ####### # ### # ### #####
# # # #     # # # # # # # #   # #     # # #             #   #         # # #   #   #       #       #   #   #   #       # #   # # # # # # #
# # # # ##### # # # ### # ############# ### # ############################# ### ### ### # ######### ### ####### ### # ##### ##### # # # #
# # # #     # # # # #   #     #           # #             #   # #         #           # #                         # #   # # # #   #     #
# ##### # ##### # # # # # # ### ################### ####### ### # ### ### # ####### # # # ### ### ### # # ############### ### # ### #####
# #     #     # # # # # # #                 #   # #                 # # # #       # # # #   #   #   # # #           #                   #
# ### # # # ### # # ##### # # ### # ######### ### ############### ### # ### ### # # # # # ######### ### # ########### ##### ######### # #
# #   # # #   # # #     # # #   # #                       #     #   #     #   # # # # # #         #   # #   #             #   #     # # #
# ### # # # ### # ######### ##### # # # ####### # # # ### # ##################### # # # # ### ### # # ##### # ################# ##### ###
# #   # # #   # #         #     # # # #       # # # #   #                       # # # # #   #   # # #     #               #         #   #
##### # ### ### # ##### ### ####### # ### ######### ######### ##### # # ######### ### # # # # # # # ### ##### ######### ### #############
#     # # #   # #     # #         # #   #     # # #         #     # # #         #   # # # # # # # #   #     #         #               # #
# # # ### # ##### ##### ### ##### ##### # ##### # ##### ##### # ####### # # # # # ### ### ### ######### ####### # ### ############# ### #
# # # #         #     #   #     #     # #             #     # #       # # # # # #   # #     #         #       # #   #             #     #
# # # ### # # # # ### # ### # # ### ##### # ########### # # # ### ##### # ####### # ##### ################# # # ##### # ##### # ##### ###
# # # #   # # # #   # #   # # #   #     # #           # # # #   #   # # #       # #     #   #             # # #     # #     # #     #   #
# # # # # ### # # # ### ### # ### # ### # # ### ##### # # # # ####### ########### # ### # # # ##### # ### ### ### ####### ######### ### #
# # # # #   # # # #   #   # #   # #   # # #   #     # # # # #                   # #   # # #       # #   #   #   #       #         #   # #
# # # # # ### # # # ### # ### # # ####### # ### # # ##### ### ##### # # # # ######### ##### # ############### # # # # # # # #############
# # # # # #   # # # #   #   # # #       # #   # # #     # #       # # # # #         #     # #   #           # # # # # # # #             #
# ### # # ### # # # # # # # ##### # ### ### ##### # ##### ### # ### # ### # ### ########### # # # ############# # ### ### ### ###########
# #   # #   # # # # # # # #     # #   #   #     # #     # #   #   # #   # #   #       #   # # #               # #   #   #   #         # #
# # # ### ### # # # # # # ### ### ##### ### # # # # ##### ### # ####### ### ####### ### ##### ### # ############# ### ##### # # ### # # #
# # #   #   # # # # # # #   #   #     #   # # # # #     #   # #       #   #       #         #   # #             #   #     # # #   # #   #
# # # # # ### # ### ### # ####### ### # # # ### ### # ### ### # # ### ##### # # ### ############### ### # ### # # ### # # ### ### ### ###
# # # # #   # #   # #   #     #     # # # #   #   # #   #   # # #   #     # # #   #               #   # #   # # #   # # #   #   #   #   #
### # # # ##### # ##### # # ##### ##### # # ### # ### # # ### # # # ### # ##### ############# ### # # # ##### # # # # # # # # ### # ### #
#   # # #     # #   #   # #     #     # # #   # #   # # #   # # # #   # #     #             #   # # # #     # # # # # # # # #   # #   # #
# # # ### ##### # # # # ### ### # ### # # ### # ######### # ### # ################### # # # # # # # # ### ### ### # ### # # ####### # ###
# # # #       # # # # #   #   # #   # # #   # #         # # #   #                   # # # # # # # # #   #   #   # #   # # #     # # #   #
# # # # # # ### ### ### # # ### ##### ### # ### ### # ### # # # ##### # # ### ##### # # # ### ##### # ### # ##### # # # # # # # # #######
# # # # # #   # #   #   # #   #     #   # #   #   # #   # # # #     # # #   #     # # # #   #     # #   # #     # # # # # # # #         #
# # ### # # ####### # # # # # # ### # # # ### # # # ### ####### # # # # ######### ##### ### # ######### # ####### ##### ### # ####### # #
# # #   # #   # #   # # # # # #   # # # #   # # # #   #     # # # # # #   # #   #     #   # #         # #       #     #   # #       # # #
# ### # ### ### # # # # # # ### # ##### # # ##### # ### # ### # ####### # # # ##### ### # # ### ############# ##### # ############# # ###
#   # #   #   #   # # # # #   # #     # # #     # #   # #     #       # #         #   # # #   #           # #     # #       #     # #   #
# ### # # # ##### # # ### # ### ### ### # # # # # # # # ########### # # ### ### # # ############# # ####### ##### # # # # ### ### # # # #
#   # # # # #     # #   # # #     # # # # # # # # # # #           # # #   #   # # #             # # #     #     # # # # #       # # # # #
# ### # # # # ### # ### # # ### ##### # ### # ####### ##### ### ######### ### # ############### ##### ##### ############### ### ### # ###
#   # # # # # #   #   # # #   #     #     # #       #     #   #         #   # # # #           #   # # #                   #   #   # # # #
# ####### # # # # # ### # # # # ##### # ### ######### # ##### # # ##### # ### ### # ##### ######### # # ####### # ### ##### ########### #
#     #   # # # # #   # # # # #     # #   #         # #     # # #     # #   #           #         # #         # #   #     #     #       #
# # # ### # # ### # # # ### # # # # # ### ### # ### # ####### ####### # ##### # ######### # ### ### # ####### # # ############### #######
# # #   # # # #   # # # #   # # # # #   #   # #   # #       #       # #     # #         # #   # #           # # #                       #
# # # ### # # # # ### # # # # # ### # # # # ##### ######### ### ######### ##### # # # # # # ### # ##### ##### # # # # ### ##### ### # ###
# # #   # # # # #   # # # # # #   # # # # #     #         #   #         #     # # # # # # #   #       #     # # # # #   #     #   # # # #
# # # # ####### # # # ##### ### # ### # # # ### # # # # ### ### # # ### # ##### # ### ##### # # # ### # # # ### # # # ### ########### # #
# # # # #       # # #     # # # #   # # # #   # # # # #   #   # # #   # #     # #   #     # # # #   # # # #   # # # # # #           #   #
# # # ####### # # # ##### ### # ######### # ### # # # # # ##### ### # ### # ### # # # ####### # # # # # # ##### # # # # # # # # # # # ###
# # #   # #   # # #     # # #           # #   # # # # # #     #   # #   # #   # # # #       # # # # # # #     # # # #   # # # # # # #   #
# # # ### ##### ### # ### # ### # # # # ##### ### # ### # # ### ##### # ### # # # # # # ########### # # # # ######### ### ### # ### ### #
# # #   #         # #   # #     # # # #     #   # #   # # #   #   #   #   # # # # # # #   #       # # # # #         #   #   # # #     # #
# ### ### # # # # # # ####### # # # # # # ### # # # # # # # # # # ##### # # # # # # # # ### ####### # # # # # # # ### ####### ##### #####
#   # #   # # # # # #   #     # # # # # #   # # # # # # # # # # #     # # # # # # # # #           # # # # # # # #   #       #     #     #
# # # ### # # # ##### # # # # # # # ##### ### # # ### # ### # # # ### # # ##### # # ### # ### ########### # ### ### ### # ########### ###
# # # #   # # #     # # # # # # # #     #   # # #   # #   # # # #   # # #     # # #   # #   # #         # #   #   #   # #           #   #
# # ### # # # # # ### ##### # ### # ### # ### # # # ##### ### # # # ### ######### # ### ##### # ### # # ### ### ### # # ##### # ##### # #
# # #   # # # # # #     #   #   # #   # #   # # # #     #   # # # # #         # # #   #     #     # # #   #   #   # # #     # #     # # #
# # # # # # ### ### # # ##### ##### ##### # ### # # # ####### # # # # # ##### # # # # ##### # # # ##### ### ####### # # # # ### # # # # #
# # # # # # #     # # # # # #     #     # #   # # # #     #   # # # # #     #   # # #     # # # #     #   #   # # # # # # #   # # # # # #
# # ### ### # # # # # # # # # # # ##### ############# # # # # ### # # # # # # ### # # ### ### # # ######### ### # ##################### #
# # #   #   # # # # # # #     # #     #     #       # # # # # #   # # # # # # #   # #   #   # # #         #                           # #
# # # # ### # ### # ### ### # # # ##### ### # ####### ####### ######### # # # ### # # ### # ##### # # # ### # # ####### # ####### #######
# # # #   # # #   #   # #   # # #     #   #         #   #   # # # # # # # # # #   # #   # #     # # # #   # # #       # #       #   # # #
# ### # # # ##### # # # # # ### # # ### # ### # # ### ### ##### # # # ##### ### # ### # # # # # # ### ##### # ##### ##### ########### # #
#   # # # # #     # # # # #   # # #   # #   # # #   #       #             #   # #   # # # # # # #   #     # #     #     #           #   #
# ### # # # # ### # # ##### ### ### # ##### # ####### # # ### ### # ########### # # ### # # # ### ### # # ### ########### # # ####### ###
#   # # # # # #   # #   #   #     # #     # #       # # #       # #           # # #   # # # #   #   # # #   #           # # #           #
# ### # # # # ### # ####### ### # # # ### # # ####### # # ### # ############### # # # # ### # # # # ### # # # ########### ### # # ##### #
#   # # # # # #   #   #       # # # #   # # #       # # #   # #               # # # # #   # # # # #   # # # #           #   # # #     # #
# ### ### # ### # # # # # # # # ##### ########### # ### # ##### ##### # # ####### # # ### # ### # ### # # ### # ####### ##### # #########
# #     # # #   # # # # # # # #   #             # #   # #     #     # # #       # # #   # #   # #   # # # # # #       #     # #         #
# # # # ### # ### # # ### ### # # ### # # # ### ### # ### # # # # # ##### # # ##### # ##### # ### # # ### # # ####### # ##### # ##### # #
# # # #   # # #   # #   # #   # # #   # # #   #   # #   # # # # # #     # # #     # #     # #   # # #   # #         # #     # #     # # #
### # ##### # ### ### # # # ### ### # # # # # # ##### # # ### ### # ####### # ##### ### ### # # ### # # # # # # # # # # ### # # # ### # #
#   #     # #   #   # # # # #     # # # # # # #     # # #   #   # #       # #     #   #   # # #   # # # # # # # # # # #   # # # #   # # #
##### ##### # ### ### # ### ### # ### # # # ### # ### # # ##### ### # # # ### # # # # ### # # # ##### # # ### ### ##### ##### # ####### #
#         # # #   #   # #   #   # #   # # #   # #   # # #     #   # # # #   # # # # #   # # # #     # # # #     #     #     # #       # #
### # # ### # # # # # # ### # # # ### # # # # ### ### # # # # ####### # ### ####### # ### # # ##### ### ### # # # ### # ####### # # ### #
#   # #   # # # # # # #   # # # # #   # # # #   #   # # # # #       # #   #     #   #   # # #     #   # # # # # #   # #       # # #   # #
### # # ####### # # # # # # # # ### # # ### ### # # # ### # ########### ####### ### ### ##### # # # ##### ### # # # # # # ### # # # # # #
#   # #   #     # # # # # # # #   # # # #     # # # # #   #           #       # #     #     # # # # #       # # # # # # #   # # # # # # #
# # ### ### # # ### # # ### ### ### # # # # # # # # ##### # # # # # ####### # ##### ######### # # ### ### ##### # # ### # # # # ### ### #
# #   # #   # # #   # # #     # #   # # # # # # # #   #   # # # # #       # #   # #         # # #       #     # # #   # # # # #   #   # #
### ### # # # # ### # ##### ### ##### ### # # ### ####### # # ##### ### # # # ### # # ### ### ### ### ##### ### # # ### # # ### # # # # #
#     # # # # # #   #   #     # #       # # #   #       # # #     #   # # # # # # # #   # # #   #   #     #   # # #   # # #   # # # # # #
# # # ##### # ### # # ### # # # # # # # # # # # # # # # # # # ### ### # # ##### # ##### ### ################# # ####### ### # ### # #####
# # # #     # #   # #   # # # # # # # # # # # # # # # # # # #   #   # # #             # #                   # #       #   # #   # #     #
### ### # # # ### # ##### # # # # # # ### # # # # # ### # # # # ### ########### # ####### ########### # # # ### # # ### ######### # # # #
#   #   # # #   # #   #   # # # # # # #   # # # # #   # # # # #   #           # #                   # # # #   # # #   #         # # # # #
# # ##### # ##### # # ### # # # # # # ### # # # # ### # # ##### ### ##### # ##### # # ### ####### ##### # # # ### ### ### ######### # # #
# # #     #   #   # #   # # # # # # #   # # # # #   # # #     #   #     # #     # # #   #       #     # # # # #     #   #   #     # # # #
# # ### # # # # # ### ### # # ### ### # ### # # # # # # # # ### ### # # # # # # # # # # # ##### # # # # # ### ### # ####### # ####### # #
# # #   # # # # # #     # # # #     # #   # # # # # # # # # # #   # # # # # # # # # # # #     # # # # # #   #   # #       #         # # #
# # # # # # # ####### ### # ### # # # # ### ### # # ##### ### ######### # ##### # # # # # ##### # # ### ##### # # ##### ####### ### ### #
# # # # # # # #         # # #   # # # #   #   # # #   #               # #     # # # # # #     # # #   #     # # #     #       #   #   # #
##### # # # # ### # # ######### # ##### # # # ### ##### # # ##### # ### # ####### # # # ######### # ##### # # # # # # # # ##### # #######
#   # # # # # #   # #     #     #     # # # #   #     # # #     # #   # #       # # # #         # #     # # # # # # # # #     # # # #   #
### # # # # # # # ### # ####### # # # # # # ######### ### # ### # # # ### # ### # ##### # # ##### # # ######### # # # # ##### # ### # ###
#     # # # # # # #   #   #     # # # # # #         #   # #   # # # #   # #   # #   # # # #     # # #         # # # # #     # # #       #
# # ### # # ### # # # # ##### # # # ### # # # # # # # # ### ### # ### # # ########### # ####### # ####### ######### # # ### ##### #######
# # #   # # #   # # # #   #   # # #   # # # # # # # # # #     # #   # # #           #         # #       #     # # # # # # #             #
### # # # # # # # # # # ### # # # # ### # # # ### # # ### # # # ##### ### # ### ####### ##### ### # # # ##### # # ####### ########### ###
# # # # # # # # # # # #   # # # # #   # # # #   # # #   # # # #     #   # #   #       #     #   # # # #     # # #     #   #         #   #
# # # ### ### # ##### # ### ### # # # # ### # # ### ### # # # ####### # ### # # ### # # # # ### # ### # ####### # ##### ### ####### ### #
#   # #     # # #     #   # #   # # # # #   # # #     # # # #       # #   # # #   # # # # #   # #   # #   # # #                   #   # #
# # # ### ### # # # # # # ##### # # # ##### # ### # ### ### ### # ### # # # # # # ##### # ### ############# # # ########### ##### #######
# # # #     # # # # # # #   #   # # #     # #   # #   #   #   # #   # # # # # # #     # #   # # #     # # # #             #     #   # # #
# # ### # ### # ### # ### # ### # # # ### ### # # # # # # # ##### ##### # # # # ##### ### ##### # ##### # # # ##### ##### # # ####### # #
# # #   # #   # #   # #   #   # # # #   #   # # # # # # # #   # # # #   # # # #     #   #           #           # #     # # #         # #
# ### # ### # ##### # ### ########### ########### # # # # # ### # # ### ######### # ########### ####### ### ### # ##### # # ########### #
#   # # #   #   #   #   #     #               #   # # # # #     #     #         # #           #           #   #       # # #            x#
#########################################################################################################################################
