#########################################################################################################################################
#o  #       #               # #       #                             #     #         #     # #   # #                     # #             #
# # # ####### ### # ##### # # # ##### # ##### # ### ######### ####### ##### ##### ### ##### ### # # ############### ### # # ########### #
# # # #   #     # #     # #         #       # #   #         # # #   #           # #           #                   # # #               # #
# ### # ### ######### # # # # ### # ### ### ############### ### # ### ##### # ### # ########### ########### ### # ### ##### ####### #####
#                   # # # # #   # #   #   #               # #             # #   #                         #   # #         #       #     #
# # # ### # # # # ########### # ##### ####################### ################### ############### ### ### ### # # ##### ##### ###########
# # #   # # # # #           # #     #                                           # # # # #       #   #   #   # # #     #     # #         #
# # # # # # # # # ####### ### # # ### ############# ######### ### # # # ### # ##### # # # ##### # ####### ##### # # ####### ### ####### #
# # # # # # # # #       #   # # #   #           # #         #   # # # #   # #                 # # #     #     # # #       #           # #
# # # # ### # # # # # # # # # ### # ### # ####### ####### ##### # # # # # # # # ######### ####### # ##### ####### ### ##### #############
# # # #   # # # # # # # # # #   # #   # #               #     # # # # # # # # #         #       #       #       #   #     #           # #
# # # # # # # # # ### # # ### # # ### ### ### # # # ##### # ####### ####### ####### ################# ### # ### # ##### ### ### ### ### #
# # # # # # # # #   # # # #   # #   #   #   # # # #     # #       #   # # #       #                 #   # #   # #     # # #   #   #   # #
### # # ##### # # # # # # ### ### ### ####### # # # ####### # ####### # # ##### # ######### ############### # ##### ##### ### ### ##### #
#   # #     # # # # # # #   #   #   #       # # # #       # #     # # #   #   # #         #               # # #   #         #   #       #
# # ####### # # # # ### # ### ### ### ##### ######### ##### ####### ### ### ############# ### ############# ### ################### ### #
# #       # # # # # #   #   # #     #     #         #   # # # #                         #   #             #               #       #   # #
# # # # # # ####### ### # # ##### # # # # # ####### ##### ### # ### ######### # # ### # ### # # ### ####### ####### # ##### ####### #####
# # # # # #       #   # # #     # # # # # #       #               #         # # #   # #   # # #   #       #       # # #           #     #
# ### # # # # ### # # # # # # ### # # # # # ##### # ### ##### # # ####### ##### ##### ##### ### ############### # # ### ### ##### ##### #
# #   # # # #   # # # # # # #   # # # # # #     # #   #     # # #       #   #     #       #   #     #         # # #       #     #     # #
# ### # # ####### # ### ### # # ##### ##### ######### # # # ### # # # ######### # # # ### # ##### ### ##### # ### # # ### # # # # #######
# #   # #       # #   #   # # #     #     #         # # # #   # # # #         # # # #   # #     #         # #   # # #   # # # # #       #
# ### # # # ### ##### # ### # # # # # # ### # ### # # # ### # # # # # ### ##### # ### # # ####### ### ### # ##### # ##### # ### # ##### #
# #   # # #   #     # #   # # # # # # #   # #   # # # #   # # # # # #   #     # # # # # #       #   #   # #     # #     # #   # #     # #
# # # # # ### ### ##### ### ##### # # # ### # # ##### ##### # # ### # ##### # # ### # ##### ### # # # ### # # ##### # ### ### # ##### # #
# # # # #   #   #   #     #     # # # #   # # #     #     # # #   # #     # # #     #     #   # # # #   # # # #   # #   #   # #     # # #
# # # # # ### # # ### # # ### ### # # # ### # ######### ### ### # ### ##### # # # ##### # # ### ##### # # # # # ### # ### ### # # # # ###
# # # # #   # # #   # # #   #   # # # #   # #         #   #   # #   #     # # # #     # # #   #     # # # # #     # #   #   # # # # #   #
# # ### # ####### ### # # # # # ### # # ### ##### ##### # # ##### ### ##### ### ### # # # ##################### ### # ### ##### # #######
# #   # #       #   # # # # # #   # # # #       #     # # #   #     #     #   #   # # # #                     #   # #   #     # #       #
# # # # # # ### ### # # # # # ##### ### ### ### ### ######### ### # # # # ######### # ######### # # ##### ############### ### ##### ### #
# # # # # #   #   # # # # # #   # #   # #     #   # #   #   #   # # # # #         # #         # # # #   #               #   #     #   # #
### # # # # # # # # # ### ### # # ######### ### ### # ### ### ### # # # # ### ### # # ### # ### # ### ####### # ####### ### # ###########
#   # # # # # # # # #   #   # #           #   #   #         #   # # # # #   #   # # #   # #   # #           # #       #   # #       # # #
### # # ### ### # ### ### # ### ### # # ### # ### ### # ####### # # # # # ### ### ####### # ########### ########### ################# # #
#   # #   #   # #   #   # # # #   # # # #   #   #   # #       # # # # # #   # # #   # # # # #   # # # # #         #       #   # #   # # #
### ######### # # # # ##### # # ### ##### # # # ### ### ##### ##### ### ####### ##### # ##### ### # # ### ################# ### # ### # #
#           # # # # #   # # #     #     # # # #   #   #     #     #   #                                         # # #     # #       #   #
### # ####### ######### # ### # ##### ######### ### ### # ### ### # ##### ##### ############### ##### # ######### # # ##### # ######### #
#   #       #         #     # #     #         #   #   # #   #   # #     #     # # #           #     # #     # #     #                   #
# # # # ### ### ##### # # # # # # ############# ### ### ####### ######### ####### # ########### # ### # # ### # ##### ### ### ###########
# # # #   #   #     # # # # # # #     #     # # # #   #       #       # #                     # #   # # #   # #     #   #   #   #       #
# # # # # # # # ### ### # ### # ####### ##### ### ##### # ### # # # # # # # # ########### ### ### ### ##### # # ##### ########### #######
# # # # # # # #   # #   # #   #                       # #   # # # # #   # # #           #   #   #   #     #       # #   #               #
# # # # ##### # ### ### # # # # ########### ##### # ##### ######### # ##### # ### ##### ### # ### # ####### ##### # # ### ########### ###
# # # #     # #   #   # # # # #           #     # #     #         # #   #   #   #   # #   # #   # #       #     #               #   # # #
##### # # ### # # # # # # # # # ########### # ### # ####### ##### ####### # # # ##### ######### ########### # # # # # # ######### ##### #
#     # #   # # # # # # # # # #           # #   # #       #     #       # # # #               #           # # # # # # #                 #
### # ### # ### ##### # # ### # # # # # ### # ############### ### # # ##### # # # ### # # ##### ##### ##### # ### # # ######### #########
#   #   # #   #     # # # #   # # # # #   # #               #   # # #     # # # #   # # #     #     #     # #   # # #         #       # #
# # # # ##### # # ####### # # # # ### # ##### # # # ### ######### # ##### ### # # # # ### ### # # ####### # # ### ### ########### ### # #
# # # #     # # #   # #   # # # #   # #     # # # #   #         # #     #   # # # # #   #   # # #       # # #   # #             #   #   #
# # # # # ##### ##### ### ### # # ### # ##### ### ##### # ################### # ### ##### # ##### # # ########### ### # # # # # #########
# # # # #     #       #   #   # #   # #     #   #     # #             # # # # #   #     # #     # # #           # #   # # # # #       # #
# # # # # ### # ######### # # # # # ### # # ##### ### # # ############# # # ####### ### # # # # # # # # ######### # # # # # ######### # #
# # # # #   # #         # # # # # #   # # #   #     # # #               #       # #   # # # # # # # # #         # # # # # #         #   #
# # # # # ### # # ##### ### # ### ### # # # ##### # ### # ##### ##### ### ####### ### # # # # ####### # # # # # # # # # # # # # #########
# # # # #   # # #     #   # # #     # # # #     # #   # #     #   # #       #       # # # # #       # # # # # # # # # # # # # #         #
##### # # ### # # # # ### # # # # # # # # ####### # # ### # # ### # ####### # ########### ### ##### # ### # ##### ##### # ### # # ##### #
#     # #   # # # # #   # # # # # # # # #       # # #   # # #   #         #             #   #     # #   # #     #     # #   # # #     # #
# ### ### # ### ### # # ##### # # ### ### # # # # ### ### # ############### # # # ### # # # # ####### # # # # ### ##### # # ### # # #####
# #     # # # #   # # #   #   # #   #   # # # # # #     # #   #         #   # # #   # # # # #     # # # # # #   #     # # # #   # #     #
##### # # # # # ### # ### # # # # ### ### # ####### # # # # # # ##### # ### # # ### ####### # # # # # ##### ##### # # # # # # # # ### ###
# #   # # #   #   # #   # # # # #   #   # #     #   # # # # #       # #   # # #   #       # # # #   #     #     # # # # # # # # #   #   #
# ### ### # ### ### # # # # ### # ### # # # # ### # # # ### # # # # ### ### ##### # ##### # # # ######### ### # # # # ######### # ### # #
#       # #   #   # # # # # #   #   # # # # #   # # # # #   # # # #   #   #     # #     # # # #         #   # # # # #         # #   # # #
# # # # ### # ##### # # ##### ### # # ### # # # # # # # ### # # # # # # ### ### ### ### ##### ############# # ##### # # ######### ##### #
# # # #   # #     # # #   #   #   # #   # # # # # # # #   # # # # # # #   #   #   #   #   #               # #   #   # #       #       # #
# # # # ### # ####### ### ##### # # ####### # # ### ### ### ### # # # ### # # # # # # # # # # ######### ########### # # ######### # ### #
# # # #   # #       #   # #     # #       # # #   # #     #   # # # #   # # # # # # # # # # #         #         # # # #         # #   # #
# # # # # ### # ##### # ######### ### ### # ### # ### # # # ##### ### ### ### # ##### ####### # ### ### ### ### # # ### # # # # ### # ###
# # # # #   # #     # #   #         #   # #   # # #   # # #     #   # #     # #     #     #   # # #   #   #   #   #   # # # # # #   #   #
# # ### # # ##### ### ### ##### # ########### ### ##### # # # # ##### ### # # # # # ### # # ### # ############# ### # ### # # ##### # # #
# #   # # #     #   #   # #     #           #   #   #   # # # #     #   # # # # # #   # # # #                 #   # #   # # #   #   # # #
### # # ### # # ### ####### # # # ########### # # ### # # # ##### # # # # # # # ##### ### # # # # # ### ##### ####### ####### # # # # # #
#   # # #   # #   #       # # # #           # # #   # # # #     # # # # # # # #     #   # # # # # #   #     #       #       # # # # # # #
### # ### # # # ### # # ### # ### ####### ### ### # # # # # ### # ### ### # # ##### ### # # # # # ####### # # # ############# # # # # # #
#   # #   # # #   # # #   # # #         #   #   # # # # # #   # #   #   # # #     #   # # # # # #       # # # #   #         # # # # # # #
# # # ##### # ####### # # # ### # ### # # ### ### ### ### # # ########### ############### ### # ### # # # ##### ### ####### ##### # # # #
# # # #     #       # # # # #   #   # # #   #   #   #   # # #           #               #   # #   # # # #     #           #     # # # # #
# # ##### # # ### ########### # # # # # # ### # # ### ### # ##### ####### # # # ### ##### # # # ##### # # # # # # ############### ##### #
# # #     # #   #         #   # # # # # #   # # # # #   # #     #       # # # #   #     # # # #     # # # # # # #               # #     #
# # ### # # ### # # ########### ### # # # ####### # # ##### ####### # # ################# # # # # # # # # ##### # # ##### # # # # # ### #
# # #   # #   # # #         #     # # # #       # #     #         # # #                 # # # # # # # # #     # # #     # # # # # # #   #
# # ### ### # # ##### # ##### # ####### ######### # # # # # # # # # ##### ##### # ### ##### ### # ### ### # ##### # # # # # # ######### #
# # #   #   # #     # #     # # #   #           # # # # # # # # # #     #     # #   #     #   # #   #   # #     # # # # # # #     #     #
# # # # ### # # # # # # # # # # # ### # # ### ##### # # ### ########### # # # # # # ############### ####### # ### ### # # ### ### ### # #
# # # # #   # # # # # # # # # #     # # #   #     # # #   #   #       # # # # # # #   #           #       # # #     # # #   #   # #   # #
# # # # # ### # # # # # # # # # # # ##### # ##### # # ##### ### ##### ### # # # # # ### ########### # # # ### ### # ######### # # # # ###
# # # # # #   # # # # # # # # # # #   #   #     # # #   #           #   # # # # # #               # # # #   #   # #         # # # # #   #
# # # # # ### ### # # # ##### ### ### ### # ##### ### # ### ##### # # ##### ### ### # # # ##### # ##### # # # ### ################# # ###
# # # # # #     # # # #     #   #   #   # #     # #   # #       # # #     #   #   # # # #     # #     # # # #   #               #   #   #
# # # # # # # # # ### # # ### # # ####### # ### ### # # # # # # # ########### ####### # # ### ##### # # # ####### ### # # # ##### # # ###
# # # # # # # # #   # # #   # # #     # # #   #   # # # # # # # #           #     #   # #   #     # # # #       #   # # # #     # # #   #
# # # # # # ### ### # ### # # ### # # # # # ####### ### ### ### ### # ####### # ####### # ### # # ### # # # # ### ### ### ##### # # #####
# # # # # # #     # #   # # # #   # #   # #       # #     #   #   # #       # #       # #   # # #   # # # # #   #   #   # # # # # #     #
# # # # ##### # # # # ### # # # # ### # # ### ####### # ### ### ### ####### ######### # # ##### # ####### # ##### ### ##### # ####### ###
# # # # #     # # # #   # # # # #   # # #   #       # #   #   #   #       #         # # #     # #       # #     #   #               #   #
# # # # ### ### # ### # # ##### # # # ### ### # ####### # # ### ### # ##### ### ### ### ### ### # # # # # # ##### ### ####### ### ### ###
# # # #   # #   #   # # #     # # # #   #   # #     #   # # #     # #     #   #   # #     #   # # # # # # #     #   #       #   #   # # #
# ### # # # ### # # # # ### ### # ### # # # # # ####### # ### # # # # # # # # # ### ### # # ### ### # # # ##### # ##### # ##### # # # # #
# #   # # # #   # # # #   #   # # # # # # # # #     #   #   # # # # # # # # # #   #   # # #   #   # # # #     # #     # #     # # # #   #
### # ### ### # ### # # # # ### ### # # # # # # ####### ##### # # # # ### # ### ####### ### ######### # # ### # # ####### # ### # # # ###
#   #   # #   #   # # # # #   # #     # # # # #     # #     # # # # # # # #   #       #   #         # # #   # # #       # #   # # # #   #
# # # ### # # # # # # # # # # ### # # # # # ### # # # # ### # # # ### # ### # # ####### ### ########### # # ### # ##### ### ### # # # ###
# # # #   # # # # # # # # # #   # # # # # #   # # # #     # # # #   #     # # #       #   #           # # #   # #     #   #   # # # #   #
### ##### # # # ####### # # # # # # ##### # ### ####### # # # ### ##### # ### # # ### ### # ######### # # ### # ### ########### # ### # #
#       # # # # #     # # # # # # # #     #   #     #   # # # #       # #   # # #   #   # #         # # #   # #   #         #   #   # # #
# # # # # # ### # ##### # ### ### # ##### ####### # # # # # # # # ### ######### # # ##### ### # ### ### # ##### # # ### ##### # # ### ###
# # # # # # #         # #   # #   # #           # # # # # # # # #   #         # # #     #   # #   #   # #     # # #   #     # # # #     #
# # # # # # # # ##### # ##### ### # ### # ####### # ### # # # ### ### ##### # # # ### # ######### ####### # ### # # ### ### # # ##### # #
# # # # # # # #   # # #     # #   # #   #       # #   # # # # #     #     # # # #   # #         #   #   # #   # # #   #   # # #   #   # #
# ### ### ##### # # ####### ### # ##### # ### ##### # # ### # ### # # # ##### # # ### # # # # ####### ##### ### ### ### # ### # # # # # #
# #   #   #     #         #   # # #     #   #     # # #   # # #   # # #     # # #   # # # # #             #   #   #   # #   # # # # # # #
# ### ### ##### # # # # # # ### # # # ### # # # # ####### ####### # # # # ### ### # # # # # # ######### ### # ### # # ####### ### ### # #
#   # #   #     # # # # # #   # # # # #   # # # #       #   #     # # # #   #   # # # # # # #         # #   #   # # # #   # #   #   # # #
# ### ### # # # # # # # ######### ### ### ### ##### ############# # # ### ######### # # ### # ##### # # ### # # # # ### ### ######### ###
# #   #   # # # # # # #         # #   #   #       #   #       #   # #   #         # # #   # #     # # # # # # # # #                 #   #
# # # ### ### # # ### # # ### # ##### # # ### # # ##### ####### # ##### # ### # ### ### # # ##### ####### ##### ### # # ##### ### # #####
# # # #     # # #   # # #   # #   #   # # #   # #   #       # # #     # #   # #   #   # # #     #       #     #   # # #     #   # #     #
# ####### ##### ### # # # ##### # ##### ##### ### ### ####### ### ####### # # # # # ####### ### ######### ######### ##### # # ###########
# #         # #   # # # #     # # #       #     #         #   # #       # # # # # #     # #   #                   #     # # #           #
# ####### ### ### ### # # # ####### # # ##### ### ### ##### ### # ### # # ##### ### # # # ##### ######### # # # ### # # ### ### #########
# #             #   # # # #     #   # #   #   #     # #   #     #   # # #   # #   # # #     #           # # # #   # # #   #   #         #
# # # # # # # ### ##### ### ########### ##### # # ##### ### ##### ######### # # # ############# # # # ### # # ### ##### ##### # ### # ###
# # # # # # #   #     #   #     #           # # #   #           #         #   # #             # # # #   # # #   #     #     # #   # #   #
# # # # # # # ### # ### # # # ##### # # ### # # # # # ### ############# ############### ### # ### # ##### # ##### # ### # # # # # #######
# # # # # # #   # #   # # # #     # # #   # # # # #     #           # # # # #         #   # #   # #     # #     # #   # # # # # # #   # #
# ##### # # # # # # ### # # ####### # # # # ##### # # # # ### ### ### ### # # ##### # ### ### ########### # # ### # ### ######### # ### #
# #     # # # # # # #   # #       # # # # # #     # # # #   #   #   # #           # #   #   #         # # # #   # # #         # # #   # #
# # # # # # # ### # # # # # # ####### ### # ### # ##### ############# # ####### ### ### ############### ######### # ### ### ### ### ### #
# # # # # # #   # # # # # # #     #   #   # #   #     # # # # #               #   #   #       #     #           # #   #   #       # # # #
# # ### # # ##### # ### # # ##### ### ##### ##### ####### # # # ### ##### ### ######### ### ### ##### ################# ### ####### # # #
# # #   # #     # #   # # #     # #   #     #                     #     #   #         #   #                           #   #            x#
#########################################################################################################################################
