#########################################################################################################################################
#o    #   # #               #       #         #           # #           #       #   # #   #                                       # #   #
# ##### ### # ##### # ####### ##### # ######### ########### # ########### ####### ### # ### ########### # ### ### ##### ####### # # ### #
# #     # #       # #             # #               #                   #               #             # #   #   #     #       # #   #   #
# # ##### # ##### ### ### ########### ##### ######### ##### ### ######### ### ### ##### # ######### ### ### ##### ################### ###
#               #   #   #                 #               #   #             #   #   # #     #     #   #   #     #     #       #   #     #
# # # # # ########################### # ############# # ### ##### ##### ### ####### # ### # # ################# ### ### ####### ### #####
# # # # # #       # # #             # #           # # #   #     #     #   #       #     # #                 # #   # #       #           #
# # # ### # ####### # # ########### ### ##### ##### ####### # # # # ### # ##### # # ######################### ####### ##### # ###########
# # #   #                         #   #     #             # # # # #   # #     # # #                       #       #       # # # # #     #
##### # ########### # ##### ####### ##### ######### # # # ####### # ### ### # ### # ########### ####### ### ####### ### # ### # # # #####
#     #           # #     #     #       #         # # # #       # #   #   # #   # #           #       #   #   #   # # # #     #         #
### # ### ### ### # ########### ##### # # # # # ##### # # # # ##### # # # ##### # # # ##### # ##### ####### ### ### # ######### ### # ###
#   #   #   #   # #           #     # # # # # #     # # # # #     # # # #     # # # #     # #     #                               # #   #
# # # # # # ##### # # # ########### ##### # # ### ####### # ####### ### # # # ####### # # ### # ########### # ##### ### ######### #######
# # # # # #     # # # #           #     # # #   #       # #       # #   # # #       # # #   # #           # #     #   #         #     # #
# # # # # # ### # # ### ### ### # ####### ####### # # ### ### # # ##### ##### ######### # # # # ####### # # # # ### ######### ### ##### #
# # # # # #   # # #   #   #   # #       # #     # # #   #   # # # # # #     #         # # # # #     # # # # # #   #         # # # # # # #
### # # ### # # # # # ##### ############# # ####### # # # ##### # # # ########### ##### ######### ### ##### ### # ############# ### # # #
#   # #   # # # # # #     #             #         # # # #     # # #       # #   #   # #         #         #   # #           #     #     #
### # ### # ### ##### ### ##### ########### ### # ##### # # ####### ####### # ##### # ######### ### # ##### ### # # # ####### ##### #####
#   #   # #   #     #   #     # #         #   # #     # # #   #   #       # #     #           #   # #   # #   # # # #                 # #
##### # ######### # ### # ##### # ############### ### ######### ### ####### # ### ########### ########### ####### # # # # ##### ### # # #
# #   #         # #   # #     #                 #   #   # # # # #   #   #       #           #       #           # # # # #     #   # #   #
# ### # ### ### ### # ######### ########### ##### ### ### # # # # ### ### ##### ######### ########### ####### ### # # # # # ### ### # # #
#     #   #   #   # #       # #           #     # # # # # #   # # #           #         #   #   #   # #     #   # # # # # #   #   # # # #
### # # # # ##### ### # # # # ### ##### ### ### ### ### # # ### # # ### ##################### ### ### # ####### # ######### ######### # #
#   # # # #     # #   # # #     #     #   #   # # # # # # #     #     #   # # #             # #               # #   #     #         # # #
# # ### ########### # # ##### # ####### ### ##### # # # # # ##### ### ##### # # ####### ##### # ########### ### ##### ##### # ######### #
# # #           #   # #     # #       #   #   #   #                 #                 #                   #   #           # #         # #
# # ### ### ####### # # # ### ################# ### ####### # # # # # ####### ######################### # ########### # # ### ### ##### #
# # #     #       # # # #   #                             # # # # # #       #                         # #           # # # #     #     # #
# # ### # # # # # # # # # ##### # # # # # # ####### # ### ### # # # # # # # # ### ##### ####### ### ### ####### ##### # # # # # # # ### #
# # #   # # # # # # # # #     # # # # # # #       # #   #   # # # # # # # # #   #     #       #   #   #       #     # # # # # # # # #   #
### # # ### ### # ### # # # # # ### # # ##### # # # # # # # # # # # # ### # # # ##### # ### ### # ####### ##################### # ##### #
# # # #   #   # #   # # # # # #   # # #     # # # # # # # # # # # # #   # # # #     # #   #   # #       #         #           # #     # #
# # # # ### ### # # ##### ##### # # # # # ### # ######### # # ### # # # ### # # # # ### ####### ################### ############# # ### #
# # # # # #   # # # #         # # # # # #   # #     #   # # #   # # # #   # # # # #   #       #                                 # # #   #
# # # ### # # # ### # # # # ### # ### # # ### # # # # ### # # ### ### # ####### # ##### # ### # ### # ### ### ####### # ### ##### # ### #
#   #     # # #   # # # # #   # #   # # #   # # # #     # # #   #   # #   #   # # #   # #   # #   # #   #   #       # #   # #   # #   # #
# ### ##### # ##### # # # # ### # # ### ##### # # # ### ##### ##### # # # # ### ### ##### ####### # # ### # ### ### # ### # # ######### #
# #       # #     # # # # #   # # #   #     # # # #   #     # #   # # # #     #         #       # # #   # #   #   # #   # #           # #
# ### # ### ### # # # ### ### ### # # # # ##### ### # ######### ####### # ##### # ### ### # ### ##### ######### # ##### # # # ###########
# #   #   # # # # # # #     #   # # # # #     #   # #                 # #     # #   #   # #   #   #           # #     # # # #           #
# # # # ##### ######### # ##### # # ### ##### # ### # ##################### ### # ### ### ### ### ##### ### ########### # ####### ##### #
# # # # #             # #     # # #   #     # #   # #                     #   # #   #   #   #   # # # #   #           # #       #     # #
# ### # # ############# # # # # # # ####### ### ### # # # ##### ############### ##### # ########### # ##### ### ##### ### # # ##### #####
# #   #               # # # # # # #       #   #   # # # #     #       #       #     # # # #   # #         #   #     #   # # #     #   # #
### ### # # # # ####### # # ##### # ### # # ### ### # # ##### ######### ######### # # ### # ### # ##### ##################### ##### ### #
#   #   # # # #       # # #     # #   # # #   #   # # #     #                   # # #                 #                     #     #     #
# ### # # # # ### ### # # # # ####### # ##### ######### # ### # # # # ################### ### ##### # # # # ### ##################### ###
# #   # # # #   #   # # # # #       # #     #     #     #   # # # # #                   #   #     # # # # #   #                     #   #
# ### # # # # # # # # ### # # ### # # ######### # # ### ########### ### ### # # ### ########### # # # # ############### # ### ### # # ###
# #   # # # # # # # #   # # #   # # #         # # # #             #   #   # # #   #           # # # # #               # #   #   # # # # #
##### ### # # ####### ##### # # ### # # ### ##### ### # # ####### # # # # # ##### # ##### ### # # # # # ### # # # # # # # # ### ##### # #
#       # # #       #     # # #   # # #   #     # # # # #       # # # # # #     # #     #   # # # # # #   # # # # # # # # #   #     #   #
# # # ### # # ### # # ### # # ##### # # ### ### ### # # # # ######### # # # # ### # # # # ### # ##### # # # # # # # # # ##### ###########
# # #   # # #   # # #   # # #     # # #   #   #   #   # # #   # # #   # # # #   # # # # #   # #     # # # # # # # # # #     #         # #
# ### ### # # # # ### # # # # ##### ### # ####### # # ### # # # # ### ############# # # # ######### # ##### ####### # ### ##### ##### # #
# #   # # # # # #   # # # # #     #   # #     # # # # #   # #       #             # # # #         # #     #       # #   #     #     #   #
# ### # ### ##### ### # # # # # # # ### # # ### ### # # # # # ### # # ### ### ####### # # # # ####### ##### ### ##### # # ####### #######
# #       #     #   # # # # # # # #   # # #       # # # # # #   # # #   #   #       # # # # #       #     #   #     # # #       #       #
### # # # # # # ####### ### # # ########### ##### # ### # ### ### # # # # # # # ######### ### # ### ### # # # ##### # # # # # ##### #####
#   # # # # # #       #   # # #           #     # # #   #   #   # # # # # # # #   # # # #   # #   #   # # # #     # # # # # #     #   # #
# # # # # # # # # # ####### # # ### ######### # ####### # ### ##### # ### ### ##### # # ##### ##### ##### ### # # # ##### ######### # # #
# # # # # # # # # #   #   # # #   #         # #     #   # #       # #   #   #             # #     #     #   # # # #     #         # # # #
# ### # # ### ### # # # ### # # # # # # # ### # ####### # ### # ### # # # # # # # ### ### # ############### ##### ############# ####### #
# #   # #   #   # # #     # # # # # # # #   # #   #   # # #   #   # # # # # # # #   #   #                 #     #   # # # # # #   # #   #
# # # ### # # # # # ### ####### ######### # # ##### ##### ### # # # ##### ##### ### ### ##### # # ####### ####### ### # # # # ##### # ###
# # #   # # # # # #   #     #           # # #         # #   # # # #     #     #   #   #     # # #       #     # # #                     #
# ### # # # ### ##### # ####### ####### ### # # ### # # # ### # ### # # # # ### # # # # # # # ####### # ####### ### ##### # # ### ### ###
# #   # # #   #     # #       #       #   # # #   # #   #   # #   # # # # #   # # # # # # # #       # #                 # # #   #   #   #
# ### ### ### # ### ### ####### # # # ##### # # ### ### # ### ##### # # # # # # # ### ### # # # # ### # ########### ##### ### # # #######
#   # #     # #   #   #     #   # # #     # # #   #   # # #       # # # # # # # #   #   # # # # #   # #           #     #   # # #       #
# # # ### ##### # # # ### # # # # # ######### # ### ### # ### ### # # # # # # # # ### ### # # ########### # ### ### # # # # ### # # ### #
# # # #       # # # #   # # # # # #         # #   #   # # #     # # # # # # # # #   #   # # #     #     # #   #   # # # # #   # # #   # #
# ### # # # # ##### ### ##### # # # # # ### # # ### # # ##### ####### ### # ### # ################# ##### # # # ### ### # # ### # #######
# #   # # # #   #     #     # # # # # #   # # #   # # # #           #   # # #   #                       # # # #   #   # # #   # #       #
# # # # # # # # # # # # ### ### ### # ### ### # # # ### ##### ### ##### ### # # # # ##### ####### # # # ##### ##### ##### # # ### ##### #
# # # # # # # # # # # #   #   #   # #   #   # # # #   # #       #     #   # # # # #     #       # # # #     #     #     # # # #       # #
# ### ### ####### # # # ##### ##### # # ##### # # # # ### # # # # ####### # ### ### ######### ### # # ########### ##### # ### # # # # # #
# #   # #       # # # #     #     # # #     # # # # # #   # # # #       # # #   #           #   # # #           #     # #   # # # # # # #
# ### # ##### ##### # # ##### # ##### # # ### # ### # ### # # # # # # ### ### # # # ### ######### # ####### ### ######### # ### # #######
# #         # # #   # #     # #     # # #   # #   # #   # # # # # # #   #   # # # #   #         # #       #   #         # #   # #       #
# # # # # ##### ### # # # ### ##### ### # # # # ### # ##### # # # ######### ### ### # # # ### # ### ### # ##### # ##### # ### # # # # # #
# # # # #     #     # # #   #     #   # # # # #   # #     # # # #         #   # #   # # #   # #   #   # #     # #     # #   # # # # # # #
# # # # # ####### # ### # # ### ##### # # # ### # # ##### # ### # # # # # ######### ### ### ##################### ####### ##### ### # ###
# # # # #     #   # #   # #   #     # # # #   # # # #   # #   # # # # # #     #       #   #                 # #         #     #   # #   #
# # # # # ### # # # # # # # # # # ### # ####### ##### ##### # # # # # ########### # # # ##### # ### ### ### # ### ####### ########### # #
# # # # #   # # # # # # # # # # # #   #       #           # # # # # #           # # # #     # #   #   #   #     #       #   #     # # # #
# ### # # ##### ### # # # # ### # ### # ##### # # # ### # # # # ### # ##### # # # # # # # # # ### # # ########### ### ####### ##### # # #
# #   # #     # # # # # # #   # #   # #     # # # #   # # # # # #   #     # # # # # # # # # #   # # #           #   #               # # #
# ##### # # ### # # # # # # # ### ### ### ### # # # ##### # # # ### # # # ### ##### # # # # ####### # ### # # ### ##### ####### #########
# #     # #   #   # # # # # #   #   #   #   # # # #     # # # # #   # # #   # #     # # # #       # #   # # #   #     #       #         #
# ##### # ### ##### # ### ### ### ### # ########### ####### # # # # # # # # # ### # # # ### # # # # ##### ##### ##### ### ####### ### # #
# #     #   #     # # #     # # #   # #           #       # # # # # # # # # # #   # # #   # # # # #     #     #     #   #       #   # # #
####### ##### # # # ##### # # # # ######### ####### # ######### ### # # ### # # # # # # # ### ### ##### # ######### ############### #####
#           # # # # #     # #   #         #       # #       # #   # # #   # # # # # # # #   #   #     # #         #               #   # #
# # ### ##### # ### # # # # # ### # ### # ### ####### # # ### # ### # ####### # # # # # ### # ### ####### # # # ### ################### #
# # #       # #   # # # # # #   # #   # #   #       # # # # # #   # #       # # # # # #   # #   #     #   # # # # #                     #
# ### # # # # # ### # # # ### # # # # ### ### # ##### ##### # ####### # # ### # ### ### # # # # ### # ### # ### # ##### ######### # ### #
# #   # # # # #   # # # #   # # # # #   #   # #     #               # # #   # # #     # # # # #   # #   # #   #       #         # #   # #
##### # # # # # # # # # # ### ### ### ### ### # # ##### ######### # # # # # ### # # # ### ### ############# ##### # ### ############# ###
#     # # # # # # # # # # #     #   #   #   # # #     #         # # # # # # #   # # # #     #             #     # #   #             #   #
# # # # # # # # ####### # ### # ##### # ##### # # # # ######### # # ### ### ### # # # ### # # # # ### # ### # # ### # ############# # # #
# # # # # # # #       # # #   #     # #     # # # # #         # # #   #   #   # # # # #   # # # #   # #   # # # # # #             # # # #
### # # # # ### ####### ##### # ##### # # ### ##### ### ##### # # ##### # # ### ### ### # # # # ### # # # # ### # ##### ### ### ### #####
#   # # # # #         # #     #     # # #   #   #     #     # # #   # # # #   #   #   # # # # #   # # # # #   #       #   #   #   #     #
# # # # # # ### # # # ######### ### # # # ##### ### ### ### ##### # # ### # ####### # ### # # ##### ######### # ### # # # ####### #######
# # # # # # #   # # #       #     # # # #     #   #   #   #     # #     # #       # #   # # #     #         # #   # # # #       #       #
# # # ### ### # ######### # # # # # # # # ### ##### # # ### ##### ##### ##### # # # # # # ### # # # ####### ### # # # # # # # ##### # ###
# # # #   #   #         # # # # # # # # #   #     # # #   #     #     #     # # # # # # # #   # # #       #   # # # # # # # #     # # # #
# ######### ### ### # ### ##### ##### # # # # # # # # # # # # ####### # # # # ### # # # # # # # # # ### ### # # # # # # # # # # # # # # #
#       #   #     # #   #     #     # # # # # # # # # # # # #       # # # # #   # # # # # # # # # #   #   # # # # # # # # # # # # # #   #
# ######### ### # # # ####### # ### ### # ##### # ##### # # # ### # # # ### # ####### # # # # ### # # # # ##### # ### ### ### # # ### ###
#         # #   # # #       # #   #   # #     # #     # # # #   # # # #   # #       # # # # #   # # # # #     # #   #   #   # # #   #   #
# ### # ####### # # ####### # # # # ### # # ### # ##### # # ##### # # # # # # # # # # # # # # # # # ########### # ### ### ### ####### # #
#   # #   #     # #       # # # # #   # # #   # #   #   # #     # # # # # # # # # # # # # # # # # #           # #   #   #   #       # # #
# # # # ##### # ### ### # ##### # # ### # ### ##### ##### # ####### ##### # # ##### ####### # ##### ####### # # # # # ### ### # ### ### #
# # # #   #   #   #   # #     # # #   # #   #     #     # #       #     # # #     #   # #   # #           # # # # # #   #   # #   #   # #
# ### # ####### ### # ### # ##### ##### # # # # # ### # # ######### ### # # ########### ### # # # # # # # # ### # ######### # # # # #####
#   # # #         # #   # #     #     # # # # # #   # # #         #   # # #               # # # # # # # # # #   #         # # # # #     #
# # ### # # ### ### # # # # ### # ### # # ##### ### # # # # ### # # # ### # # # ####### ### # ### # ### # ##### # # # # ### ### # ### # #
# #   # # # #     # # # # #   # #   # # #   #     # # # # #   # # # #   # # # #       # # # # #   #   # #     # # # # #   #   # #   # # #
# ##### # ##### # # # # ### # ### # # ### ##### ##### # # # ### ### # # # # # ### # ### # ######### ### ### ### # # ####### # ### # ### #
#     # # #     # # # #   # # #   # #   #   #       # # # #   #   # # # # # #   # #   # #     #       #   #   # # #       # #   # #   # #
# # ### ##### # # # ##### # # ### ### # # ##### ### # # # ####### # ### # # # ### # ##### ##### ### # # # ##### # # # ##### # ### # # # #
# #   # #     # # #     # # # #     # # #   #     # # # #       # #   # # # #   # #           # #   # # #     # # # #     # #   # # # # #
# # # # # ### # ### ### ##### ### # ### # ### # # # # # # ### # # # ### # ### # # # ##### # # ### # # ####### ##### # # ##### # # # # # #
# # # # # #   #   #   #     # #   #   # # #   # # # # # #   # # # #   # # #   # # #     # # #   # # #       #     # # #     # # # # # # #
# # ####### # ##### ### # # # ### ### ### ### # # # # # # # # # ### ##### # # ### ############### # ### ########### ### # ############# #
# #     #   #     #   # # # # #     # # #   # # # # # # # # # # #       # # # #                 # #   #           #   # #             # #
# ### ### # # # ### # # # # ### # # ### # # # ### ### # # ######### ##### # # # # # ##### ### ##### # # # # ### # ### # ############### #
#   #   # # # #   # # # # #   # # #     # # #   # #   # #         #     # # # # # #     #   #     # # # # #   # #   # #   #     #     # #
# ####### # # # ### ##### ##### # ### ### ####### ### # # ### ##### ####### # ### ### # # ######### ##### # ### # # ####### ##### #######
#       # # # #   #     #   #   #   #   #       #   # # #   #     #       # # #     # # #         #     # #   # # #                    x#
#########################################################################################################################################
