#########################################################################################################################################
#o#                                         #         # #               #                   #   #                 #   #   # #       # # #
# # ### # ########### # # # ### # ### # # ### ####### # # ### # ### # ### ####### ##### ##### ### ### ##### # # # # ### ### # ####### # #
#     # #           # # # #   # #   # # #           #       # #   # #           #     #             #     # # # #                 # # # #
# ##### # ##### # # ### # # ### ##### # ####### ##### ##### ### # ### ##### ##### # # ### # ### ### ##### ####### # ####### ### ### # # #
#     # #     # # #   # # #   #     # #       #     # #   # #   #   #     #     # # #   # #   #   #     #       # #       #   #         #
# # ### # # ####### # ####### ################# ####### ### ##### ##### # # # ### # # # # ##### # ##### ##### ########### ### ###########
# #   # # #       # #       #                 #           #   # #     # # # #   # # # # #     # #     # #   #           #   #     #     #
# # ### # # ####### ######### ### ######### ### # # ########### # ##### # ##### ##### # # # # ##### ### # ############# ### ####### #####
# #   # # #       #         #   #         #   # # #             #     # #     #   # # # # # #     #   #     #         #   #             #
# # # # ### # # ### # # ####### ### # # # ##### ########### ########### ### # # ### ########### ### ######### ######### ### ### ##### # #
# # # #   # # #   # # #       #   # # # #     #           # #       # #   # # #         #     #   #   #               #   #   #     # # #
# ### # # # ### ### ######### # ##### # ####### # # # ####### ##### # ##### ### ### ##### ##### ### ### ##### ### ####### ##### ### #####
#   # # # #   #   #         # #     # #       # # # #             #       #   #   #   #       #   #         #   #       #     #   #   # #
# # ### # ######### ### # ############# # ##### ##### ### # ########### ####### ####### ##### ### # # ### ### ### ### # ######### ### # #
# #   # #         #   # #           # # #     #     # # # #           #       #             #   # # #   #   #   #   # #         #   #   #
# # ##### ### # # ############# ##### # ### # ####### # ####### ####################### ### # ####### # # ##### # ############# ### # # #
# #     #   # # #             #       #   # #       #         #                       #   # #   # # # # #     # #             #   # # # #
# # # ### ##### # ########### # ####### ##### ####### # # ### # ######### ##### # # # # # # # ### # ### # ##### # ### ### ##### # # ### #
# # #   #     # # #         # #       #     # #     # # #   # #         #     # # # # # # # #         # #     # #   #   #     # # #   # #
# # # # # # # # # # ######### # ####### # ### # ##### # # ### ##### # ##### # # # # # # ##### ##### # ####### # # ### ####### ### ### # #
# # # # # # # # #           # #       # #   #       # # #   #     # #     # # # # # # #     #     # #       # # #   #       #   #   # # #
# # # # # ### # # # # # ####### ############### ################# ### ### # ##### # # # # ##### # ##### ######### # ############### ### #
# # # # # #   # # # # #       #               #           #     # #     # #     # # # # #     # #     #   #     # #               #   # #
# # ### # # # # # # # ### # # # ####### ######### ######### ##### ############# # ##### ### ####### ####### ##### # # ### ##### # ##### #
# #   # # # # # # # #   # # # # #     #         #               #             # #     #   # #     # # # #       # # #   #     # #     # #
### ### # # # ### # # # ##### ### ### # ########### ##### ### ##### # # ##################### ####### # # ####### # ### ### ### # ### # #
#     # # # #   # # # #     #       # #       #   #     #   #     # # #                                         # #   #   #   # #   # # #
### # # # ### # # # ### ### ##### # ### # # ### ####### ### ##### # ### # # ### ##### ### ### ##### ################# ### # # # # # # ###
#   # # # #   # # #   #   #     # #   # # #           #   #     # # # # # #   #     #   #   #     # #       #       #   # # # # # # # # #
# # ### # ### ### # ### # # ### ##### ##### ##### ##### ####### ##### ### # # # ####### # # ######### ### ### ##### ##### # ########### #
# #   # # #     # #   # # #   #     #     #     #     #       #         # # # #       # # # #           #         #     # #     # #     #
### ######### ### # ####### ####### # ### ######### # # # # ### ######### # ### # # ######### ################### ### # ### ##### # #####
#           #   # #       #       # #   #         # # # # #   #   #     # #   # # # #   # #                     #   # #   #             #
### ##### # # # # # ####### # ### ##### # ### ### ####### ### ##### ##### # ### ##### ### # ##### ##### # # # ### # ### ####### ### #####
#       # # # # # #       # #   #     # #   #   #       #   #         # # #   #         #       #     # # # #   # #   #       #   #     #
# # # ####### ### # # ####### # ############# ##### # ### ############# ################# ######### ####### ##### ### # # ######### #####
# # #   #       # # #       # #   #         #     # #   # #                                       #       # #   #   # # # # #   # #     #
### # ####### ##### # # # # # ##### ### # ### # # # ####### ############# ### ##### ##### # # ##### ######### ### # # ##### # ### #######
#   #     #     #   # # # # #         # #   # # # # #                   #   #     #     # # #     #             # # # # # #             #
### ##### # # # # # # ##### # ### # ### ##### ##### # ######### # ##### # # # # # ### ####### # # # # # # # # # ####### # # ####### # ###
#       # # # # # # #   # # #   # #   #     #     #           # #     # # # # # #   #       # # # # # # # # # #                   # # # #
### # # ### # # # # # # # # # # # # # # ##### ####### ### ############# # # # # # # # # ##### ### # ### ####### ############# # # ### # #
#   # # #   # # # # # # # # # # # # # #     #       #   #             # # # # # # # # #     #   # #   #       # #           # # # # # # #
# # ### # # # # ### ### # ### # ##### # # # ### # # # ### # ##### # ##### # # # # ##### ########### ### # ##### # ############# ### ### #
# #   # # # # # #     #     # # #   # # # #   # # # #   # #     # #     # # # # #   #             #   # #   #             #   # #       #
### ### ##### ### # # # ##### # # ##### # ### # # # # # ############### # ##### ##### # # ### ### # ##### # # # # # # ##### ##### ##### #
#     # #   #   # # # #     # #       # #   # # # # # #               # # # # #   # # # #   #   # #     # # # # # # #                 # #
# # ### # ### ### # ####### # ### ### # ##### # # # # ####### # ######### # # # ### # # # # # ######### ####### ### # ############### ###
# # #       #   # #       # #   #   # #     # # # # #     # # #         #     #     # # # # #         #       #   # #               #   #
# # # # # # # ### # ### # ### # # ##### ####### # # ##### # ##### ### ####### # ##### # # # ########### # ####### # # # # ##### ##### ###
# # # # # # # #   #   # #   # # #   #         # # #     #       #   #       # #     # # # #           # #       # # # # #     #     #   #
# # ### # # # # # # ### ### # ### ### # # # ### ##### ##### # ### # ##### ### ##### ##### ######### ##### # ### # # ##### ### # ### # ###
# # #   # # # # # #   #   # #   #   # # # #   #     #     # #   # #     #   #     #     #         #     # #   # # #   # #   # #   # #   #
### # # ### # # ### # # ### # # # ### # # ##### # # ##### # ####### # ### # # # ### ### # # ##################### ### # # # ### # #######
#   # # #   # # #   # #   # # # #   # # #     # # #     # #       # #   # # # #   #   # # #                     #   #   # #   # #       #
# ### # # # # ### # # # # ############# # ### # # # # # # # ##### # # # # ########### # # # ####### ##### ##### # ##### ##### # # #######
# #   # # # # #   # # # #         #   # #   # # # # # # # #     # # # # #           # # # #       #     #     # #     #     # # #       #
# # # # ### ####### # # ####### ### ##### # ### # # ### # # ####### ##### # ### ### ### # # # ### ############### ### ########### # # ###
# # # # #       #   # #       #         # #   # # #   # # #       #     # #   #   #   # # # #   #               #   #           # # #   #
# # # # ### # # # # ### # ### ####### ####### # ### ##### # # # ### ####### ############# # # # # ##### ##### ######### ### ##### # # # #
# # # #   # # # # #   # #   #       # #     # #   #     # # # #   #       # #           # # # # #     #     #         #   #     # # # # #
# ### ### # ####### ### # ### # ### # # ### ############### # ### # ######### ######### ### # # # ### ### # ########### ####### ##### ###
# #     # # #         # #   # #   # #     # #             # #   # #                   #   # # # #   #   # #           #       #     #   #
### # ####### ### # ### # # # ######### ##### ##### # # ####### ### ### ##### ### # # ### # # # # ### ######### # ####### ########### ###
#   # #   #   #   #   # # # #     #   #           # # #       #   #   #     #   # # #   # # # # #   #         # #       #           #   #
### # ### # # # # # # # # ### ##### ### # ######### # # # # ######### ##### # ######### ### # ####### ### ##### # ### # ##### ####### ###
#   #   #   # # # # # # #   #         # #         # # # # #         #     # #         #   # #       #   #     # #   # #   # #       #   #
# # # # # ####### # # # ### # # ########### # # ### # # # ##### # # ### # # ##### ##### ####### # # ##### ####### # ##### # ### #########
# # # # # #       # # #   # # #           # # #   # # # #     # # #   # # #     #     #       # # #     #       # #     #     #         #
# # # ### ####### # ### # ##### ### ####### # ### ### ####### # # # # # ######### # # ########### ### ### # ######### ### # ### # #######
# # # #   #   #   #   # #   #     #       # #   #   #       # # # # # #         # # #         # #   #   # #         #   # #   # #       #
# ########### ### # ### # # # # # # # # # ################# ####### ### ##### ##### # ######### ### # # # # # ### ### ##### ##### # # # #
# # #             #   # # # # # # # # # #                 #       #   #     #     # #             # # # # # #   #   #     #     # # # # #
# # ### ### # # # # # ### # # ##### # ### # ### ####### ######### ##### # ##### ### ######### ### ### # # # # # # ### ### # # ##### #####
# # #   #   # # # # #   # # #   # # #   # #   #       #         #     # #     #   #         #   #   # # # # # # #   #   # # #     #     #
### # ### # # # # ### # # # # ### # ### ##### # # # ##### ##### # ### ### ######### ##### # # ### ### # ### ### ### ### # ##### #########
#     #   # # # # #   # # # #     #   #     # # # #     #     # #   #   #         #     # # #   #   # #   #   #   #   # #     #         #
# ### ### ### # # # # # # # # ### ##### # # # # # # ##### ####### # ### ### ######### ### # # ### ### # ### ### # ######### ##### # # # #
# #   #   # # # # # # # # # #   #     # # # # # # #     #       # #   #   #         #   # # #   #   # #   #   # #         #     # # # # #
# ### ##### # # # # # ### # # # # # ### ####### ### # # # ##### ### # # ### # # # ### # ### ### ### # # # # # # # # ##### # ####### # ###
#   # #       # # # #   # # # # # #   #   # # #   # # # #     #   # # #   # # # #   # # # #   #   # # # # # # # # #     # # #     # #   #
# # ### ### # # ##### # # # # # # ### # # # # ### # # # # ### ####### ### # # ### ### # # # # ### ### # ### # # # # # ####### ###########
# # #   #   # #   #   # # # # # #   # # #       # # # # #   #       #   # # #   #   # # # # #   #   # #   # # # # # #           #       #
# ##### # # ### ##### # # # ### # # # ##### # # # # # ######### # ### # # # # ####### ### # ### # ##### ### ### # # # # ### ### # ##### #
# #     # # #       # # # #   # # # #     # # # # # #         # #   # # # # #       #     #   # #     #   #   # # # # #   #   #       # #
# # ####### # # # # # # # # # # # # # # # # # ### # # ### ### ##### # # ### # # # ### # # ### # # # ########### # # ### ### ######### # #
# # #       # # # # # # # # # # # # # # # # #   # # #   #   #   # # # #   # # # #   # # #   # # # #           # # #   #   #         # # #
### ### # # ##### # # # # # # # ### # # ##### # # ### # # ### ### ####### # # # # # # # # # # ### # ### ##### ##### # # # ### # ### # # #
#     # # #     # # # # # # # # #   # #     # # # #   # #   # #         # # # # # # # # # # #   # #   #     #   #   # # #   # #   # # # #
# # # # ### # ### # ### # # ### # # ### # # # # ### # # ####### ########### # ##### ### ##### # ### # # # # # # # # # ### ### # # ##### #
# # # # #   #   # #   # # #   # # #   # # # # #   # # #   #               # #   # # # #     # #   # # # # # # # # # #   #   # # #     # #
# # # # ### # ### # ##### # # ### # # # # # ######### ##### ##### ### ##### # ### ### ######### ### ### ########### ##### # # ### ##### #
# # # # #   #   # #   #   # #   # # # # # #       #             #   #     # #                 #   #   #           #     # # #   #   #   #
# # ### # # # ### ### # # ### ### # # # # # # ####### ##### # # ####### ##### # # # # # # # # # # # # # ####### ### ##### # # # #########
# # #   # # #   #   # # #   #   # # # # # # #     #       # # #       #   #   # # # # # # # # # # # # #       #   #     # # # #   #   # #
### # # ### # # # # ### # # # ### # ### # # ####### # ############# ######### ### # # # # ##### # ##### # ### ### # # # # ### ##### ### #
#   # #   # # # # #   # # # #   # #   # # #       # #             #         #   # # # # #     # #     # #   #   # # # # #   #           #
# ##### # # # # # ##### # # # # # ##### ### ######### # ##### # # ### # ### # ####### # # ##### # ##### # # # # # # ### ##### # ##### ###
# #     # # # # #     # # # # # #     # #         #   #     # # #   # #   # #       # # #     # #     # # # # # # #   #   # # #     #   #
# ### # # # # # # # ### # # # # # # ####### ### # ### ### ### ##### # # ##### ### ### # # ### # # ### ##### # ### ####### # ### # # # ###
# #   # # # # # # #   # # # # # # #     #     # #   #   #   #     # # #     #   #   # # #   # # #   #     # #   #       #     # # # #   #
# ### # # # # # # # # ### # # ### ##### # # # # # # # # ### # # # # ### ######### ##### ##### ######### # # ### ### # ####### # # # # # #
# #   # # # # # # # #   # # #   #     # # # # # # # # #   # # # # #   #         #     #     #         # # #   #   # #       # # # # # # #
##### # # # # ##### # ####### ### ### # ### ### # ### # # # # # # ##### # ########### ####### ##### ####### ####### # # # # ########### #
#     # # # #   #   #       #   #   # # #     # #   # # # # # # #     # #     #   # #       #     #       #     #   # # # #       #   # #
####### # # ####### # ##### # ### # ##### # ### # ### # # ### # # # ##### # # # ### ### # # ### # # ### # ####### # # # # # # # # # ### #
#       # #       # #     # # #   #     # #   # #   # # #   # # # #     # # #         # # #   # # #   # #       # # # # # # # # #     # #
####### # # # ### # # ### # # ### ### # ### # # # # # # ##### ### # # # # # ### # # ##### ################# # ##### # # ##### ##### # # #
#       # # #   # # #   # # #   #   # #   # # # # # # #     #   # # # # # #   # # #     #     #     #     # #     # # #     #     # # # #
##### # # # # # # ### # ### # # # # # ####### # ##### # ### ##### # # ### # # # ### ########### ##### ### ### ### # ### # # # ######### #
#     # # # # # # #   #   # # # # # #       # #     # #   #     # # #   # # # #   #                     #   #   # # #   # # # #       # #
# # # # # # # # # ### ### ### # # # # ### # ### ##### # ### ### # # # # # # # ### ################### # # # # ####### # ##### # ##### # #
# # # # # # # # # #     #   # # # # #   # #   #     # #   #   # # # # # # # #   #                   # # # # #     # # #   #         # # #
### # # # # # ### # # ##### ### # # # ### # # # # # # # ### # # ### # # # ### ### ### # ####### # # # ####### # ### # # # # # # # ### ###
#   # # # # # #   # #     #   # # # #   # # # # # # # #   # # #   # # # # #     #   # #       # # # #       # #     # # # # # # #   #   #
# # # ### # # # # ### ### ### ##### # ### # # # # # # # # # # ##### # ### ### # # # # # # # # # # ##### ####### # ##### ### # ###########
# # #   # # # # # #     #   #   #   #   # # # # # # # # # # #     # #   #   # # # # # # # # # # #     #       # #     #   # #           #
# ### # ### # ### ### # ### ### # # # ### # # # ### # # ### # ####### ### # # ### # # # # ##### # ### # ### # # # # # ### # # # ### # ###
# #   # #   # #   #   #   #   # # # #   # # # #   # # # #   #       #   # # #   # # # # #     # #   # #   # # # # # #   # # # #   # #   #
# # # # # # # # # # # # # ### ##### # ### # ### ### ####### ####### # # # ### ### # # # # # ### # # # ### ### # # # # # ### ### # #######
# # # # # # # # # # # # #   #   #   #   # #   #   #   #           # # # #   #   # # # # # #   # # # #   #   # # # # # #   #   # #       #
# ### # ##### # # # ### # ######### # ##### # # # ### ### # # # # ### # ##### # # # # # ######### # ####### ### ### ### # # ### ### #####
#   # #   #   # # # #   #     #     #   #   # # #   #   # # # # #   # #     # # # # # #         # #       #   #   # #   # #   #   #     #
# # # # ### # # # ##### # ####### ### ##### # # # # # # # # # # ### # ######### ### ### # ############# ### ### ### ### ##### # # ### # #
# # # #   # # # # #   # #       # #       # # # # # # # # # # #   # #         #   # #   #             #   #   #   # #       # # #   # # #
# # ### ### # # # ### # # # # ### ### ### # # # # # # # ### ####### # # ########### # # ####### ### # ##### ### # # ### ### # # ##### ###
# # #     # # # # #     # # #   # #     # # # # # # # # #         # # #       #   # # #       #   # #     #   # # # #     # # #     # # #
# # # # ##### # ### # # ### ### ### # # ####### ##### # ### # # # ##### ### ### ##### ##### # # ########### ####### # # ##### ##### # # #
# # # #   #   # #   # # # #   # #   # #       #     # # #   # # #     #   #         #     # # #           #   # # # # #     #     # #   #
# # ### # ### ### # ### # # ### ### # # # # # # # # ### # # ##### ### ### ### ### ### ##### ############# ##### # # # # ### #############
# # #   #   #   # #   #   #   #   # # # # # # # # # #   # #   #     #   #   #   #   #     # #           #         # # #   #             #
# ##### ##### ### # ### ####### ### ### ### # # # # ### # # ### # ##### # # ### # ### # ##### ######### # ############### # # ##### #####
#   # #     # #   # #         #   #   #   # # # # #   # # # #   #     # # #   # #   # #               # #       #     # # # #     #     #
# ### # # # # ### ### # ### ####### ####### # # # # # # # ####### # ##### # ####### ##### ############# ##### ##### ### ### # # ##### # #
#   #   # # # #     # #   #     #         # # # # # # # #   #     #     # #       #     #             #     #             # # #     # #x#
#########################################################################################################################################
