#########################################################################################################################################
#o                    #   # #                         #                               # #             #         # #   # #             # #
# # ### ######### # ### ### # ################# ####### ################# ############# # ######### ##### ####### # ### # ##### ####### #
# #   #         # #             #       # # # #     #   #               #                         #                           #         #
# # ### ############# ########### ####### # # ####### ### ########### ############# ### # # # # # # # ##### # ########### # #############
# #   #             #         #       # #                           #             #   # # # # # # # #     # #           # #             #
# # # ### ##### ########### ### ####### # ### ### ######################### ### ##### # # ### ### ### # ########### ### # # ### ### # # #
# # #   #     #           #                 #   #                         # # #     # # #   #   #   # #           #   # # #   #   # # # #
### ####### ####### # ### # # ##### ##### ### ### ### # # ##### # ########### ### ########### ### # # ### # ####### ### ####### # # # ###
#         #       # #   # # #     #   # #   #   #   # # #   # # #               #           #   # # #   # #       #   #     #   # # #   #
# # # # ############### ##### # ### # # ############### # ### ######### ########### ####### # ### ### ### # ##### ########### # ### ### #
# # # #               #     # #   # #                 # #             #         # # # #   # # # #   #   # #     #           # #   #   # #
# # ### # ####### ####### # # ### # ### # ### ### # ### ####### ########### ##### ### # ####### ### # # ### # ### # # # # ### # ### # # #
# #   # #       #       # # #   # #   # #   #   # #   #       #   #       #                       # # #   # #   # # # # #   # #   # # # #
# # # # ##### ### # ### ##### # # # # # ##### ##### ##### ### # ### ####### ########### # # # ####### # ############# # # # # # ### ### #
# # # #     #   # #   #     # # # # # #     #     #     #   # #           # #         # # # #       # #             # # # # # #   # #   #
# # ##### # # # # ##### # ### ######### ### # ### # ##### # ######### # ### # ### ### ##### ##### # ####### ### ##### # # # # # ### ### #
# #     # # # # #     # #   #       # #   # #   # #     # #         # #   #     #   #     #     # # #     #   #     # # # # # #   #   # #
# # # ########### ##### # ### # # ### ### # # # ############# # ### # ### ##### # ######### ### ##### ##### # ##### # ####### ### # ### #
# # #           #     # #   # # #       # # # #       # #   # #   # #   #     # #         #   #   #       # #     # #       #   # # #   #
# # # # # # ##### ########### # # ### ####### ######### # ########### ####################### # ### ### ############# ##### ### # ### # #
# # # # # #     #       #   # # #   #     #                         #         # #           # #       #           #       #   # #   # # #
# # ### # # ##### ####### ### # ##### ####### # ####### ##### # # ### ######### # ### ########### # # ####### # # ### ### ##### ##### # #
# #   # # #     #           # #     #       # #       #     # # # #                 #           # # #       # # # #     #     #     # # #
# # ### ### # # ##################### ##### ### ### # # ##### ####### # ##### # ### # ######### # # ##### ########### # ####### ### # ###
# #   #   # # #                     # #   #   #   # # #     #       # #     # #   # #         # # #     #   #     #   #       #   # #   #
# ####### # ####### # # ############### ####### ### # # # ### ### # # # # ### # ####### ### ####### # # # # # ######### ### #############
#       # #       # # #                       #   # # # #   #   # # # # #   # #       #   #       # # # # #     #     #   #     #       #
# # ### ### ### ####### ######### ########### ######### # ############### # ######### # # ##### ### # ##### # # # ##### ######### ##### #
# #   #   #   #       #         #           #         # #               # #         # # #     #   # #     # # #   #   #               # #
# # # ##### ### ### # # # # ########### ####### ### # ### # ### # # ##### ##### ##### ##### # # # # # # # # # # ### ########### # # #####
# # #   #     #   # # # # #           #       #   # #   # #   # # #   #       #     #     # # # # # # # # # # #               # # #     #
# ### ##### # # # # # ### # # # # ##### # ### # # ### # ### ### ### ### # # # # ### # ####### ### ### ####### ### # # ### ##### #########
#   #   #   # # # # #   # # # # #     # #   # # #   # #   #   #   #   # # # # #   # #       #   #   #     # #   # # #   #     #     # # #
# # # # ### # # # ##### # ### # ### # ##### # ### ### # ### ### ##### ### # # # ####### # ######### # # # # # # ### # ####### ##### # # #
# # # #   # # # #     # #   # #   # #     # #   #   # #   #   #     # #   # # #       # #         # # # #   # #   # #       #     # #   #
# # # # ### # ### # # # # # ### # # # # # ### ##### # # # # ####### ### # ######### # ### ########### ##### # # ### ### ### ######### ###
# # # #   # # #   # # # # #   # # # # # #   #     # # # # #       #   # #         # #   #   # #     #   # # # # # #   #   #   #         #
# # # # ##### # # # ##### # ### ### ### ##### ############# # ### ####### ########### ### ### # ##### ### ### ### # # ######### ####### #
# # # #     # # # #     # #   #   #   #     #     #       # #   #     #             #   #         # #       #   # # #                 # #
# # # # ##### ### # # ### ##### # # # # # ######### ####### # # ### ##### ####### # ##### # ##### # ##### ####### # # # ########### # # #
# # # #     #   # # #   #     # # # # # #     # #         # # # # #     #       # # #   # #     #       #         # # #     #     # # # #
### # # # ### ##### # ##### # ####### ### # ### # ######### ##### ####### # ### ##### ########### ### # ### ##### ### # ##### ####### # #
#   # # #   #     # #     # #       #   # #               # #         #   #   #       #         # # # #   #     #   # #             # # #
### # # ### # ### # ### ### # # # # # # ### # ### ##### # ### ##### ##### # # # ####### ### # # ### ############# ########### ######### #
#   # #   # #   # #   #   # # # # # # #   # #   #     # #         #     # # # #           # # #                 # # # #     #         # #
# # ### # ### # # # # # # # # # # ############# # ##### # # # # ### ##### # # # # # ####### ######### # # ### # ### # # #################
# #   # #   # # # # # # # # # # # #   #       # #     # # # # #   #     # # # # # #       #   #     # # #   # # # #   #     # #         #
# # # # ####### # # ### ### ##### # ### ### ### ### ### ### # # # ####### # # ### ### ### ##### ######### # ##### # ### ##### # ### ### #
# # # #       # # #   # # # #   #         #   #   #   #   # # # # #     # # #   # # #   #   #           # #     #       # #       #   # #
# # # ### # # ##### ##### ##### ### ####### ### ### ##### # # # ### ### ##### ### # ######### ### ############### ### ### # ####### # ###
# # #   # # #   #                 #       #   #   #     # # # #       #     #   #       #       #         #         #             # #   #
# # ### # ##### # # # # # # ############# ####### ### ####### ####### # ##### ### # ##### ### ######### ### #############################
# #   # #     # # # # # # #             #       #   #     # #       # #     #   # #         #       # #   # # #   # #                   #
# # ### ####### ### ##### # # # # ### # # ######### # ##### ### ### ######### ### # ### ##### # # ### ##### # # ### # ######### #########
# #   #     #     #     # # # # #   # # #         # #         #   #         #   # #   #     # # #                             #         #
# # ####### ####### # # ### ### ### # ##### # ### # ### # # # ### ##### # ######### # # ########### # ########### # # # # # ####### # ###
# #       #   # #   # # #     #   # #     # #   # #   # # # #   #     # #       #   # #           # #           # # # # # #       # #   #
# # # ### # ### ####### ### ##### # ##### ##### ### # # ### ##### ### # # ### # ### ### # ##### # ######### # ### ########### ### ### ###
# # #   # # #         # #       # #     #     #   # # # #       #   # # #   # #   #   # #     # # #       # #   #       # # #   #   #   #
# # # # ##### ### # ####### # ##### # ##### ####### ####### ##### ### # # ####### # # ### ### ### # ### ### # ##### # ### # ######### ###
# # # #         # #   # # # #     # #   # #   #   # #     #     #   # # #       # # # #     #   #     #   # #     # #               #   #
# ### # # # ##### ### # # # ############# ##### ### # ### # ##### # ### # ### # ######### # ##### # # ### ### ##### # ### # ### ##### ###
# #   # # #     #   #   #                         #     # #     # #   # #   # #       #   #     # # #   #   #     # #   # #   #     #   #
# # # # # # # ### # # ##### # ######### ### # ### # # ######### ### ### ### # ########### # # # ##### # # ### ### # # # ### ####### # # #
# # # # # # #   # # #     # #         #   # #   # # #         #   #   #   # #           # # # #     # # #   #   # # # #   #       # # # #
# ### # ### # ### # # ##### ### ##### ##### ### ############### # ### ### # ##### # ##### # # ##### # # # ### ##### ### # # # # ##### # #
#   # #   # #   # # #   #     #     #     #   #             #   #   #   # #     # #   # # # #     # # # #   #     #   # # # # #     # # #
# ### # ### # ####### # ### ######### ####### ##### # ######### # # # # ### # ### ### # ##### ### ############### # ### # ##### # ### # #
#   # #   # #       # # #           #       #     # #         # # # # #   # #   #   #       #   #               # #   # #     # #   # # #
# ##### # # # # ##### # # # # # # ### ### # ####### # # ####### ### # # ### ### ####### # ### # ##### # # ### # ####### # ### ##### ### #
#   #   # # # #     # # # # # # #   #   # #       # # #       #   # # # # #   #       # #   # #     # # #   # #     #   #   #     #   # #
# ### # # # # # # # # ##### # ### ### # ### ### ##### ####### ### ##### # # ### # # ########### # # # ### ##### # ##### # ###############
# #   # # # # # # # #     # #   #   # #   #   #     #       #   #     #   #   # # #           # # # #   #     # # #     #               #
# ### # # # # # # # ####### # # # ### # # ### ### ### ########### ######### # # ### # # # # ##### # ########### # # ### # # ### # #######
# #   # # # # # # #       # # # #   # # #   #   #   #           #         # # #   # # # # #     # #           # # # #   # #   # #       #
# # # # # # # # # # # ##### # ##### # # # # ### # ### ### ############### # ####### # # # ####### ##### ### # # ####### # # # # # # #####
# # # # # # # # # # #   #   #     # # # # #   # #   #   #     #         # #       # # # #       #     #   # # # #   #   # # # # # #     #
# # # # # # # # # # # # # # # # ##### ##### # ### # # ##### ### ### ### # ### # # ### # ### ####### # # ##### ### ##### # # ### # #######
# # # # # # # # # # # # # # # #     #     # #   # # #     # #     #   # #   # # #   # #   #       # # #     #         # # #   # #       #
# ### # # # # # # # # ### # # ##### # ### # # # # # ##### ### ####### ### ############# # ########### # # ################# # ##### #####
#   # # # # # # # # #   # # #     # #   # # # # # #     #           #   #             # #       #   # # #                 # #     #     #
# # ### ### # # # # # ##### # # ### # # ### ##### # ### # # # ##### ####### # ################### ##################### # ### # # #######
# #   #   # # # # # # #   # # #   # # #   #     # #   # # # #     #       # #                                         # #   # # #     # #
# # # # # # ### # # # # ### # ### ### # # ####### # ##### # # # ##### ##### ##### # ##### ### # # ##### ##### ### # ### ### # ######### #
# # # # # #   # # # #     # #   #   # # #       # #     # # # #     #     #     # #     #   # # # #   #     #   # #   #   # #           #
# # # # ### # # ##### # ##### # ### ### # # # # ### ### ##### ### ### ### # # ####### # # # # ### # ##### ######### ### # # # # # #######
# # # # # # # # #     #   # # #   #   # # # # #   #   # #       #   #   # # #       # # # # #   #       #     # # #   # # # # # #       #
# # # # # ### # ### # # # # # ############# # ##### ### ### # ### # # ##### # # # ##### # # # # # # # # ##### # # ### # ### # ### # # # #
# # # #     # # #   # # #   #             # #     #   #   # #   # # #     # # # #     # # # # # # # # #     #       # #   # #   # # # # #
# # # # # # ### ### # # # # # ### ####### ######### ### ##### # # ### ##### # ### ##### ### # # # ### # ### # # ### ### # # # # # # # ###
# # # # # # #   #   # # # # #   #       #       #     #     # # #   #     # #   #     #   # # # #   # #   # # #   #   # # # # # # # #   #
# # ### # ##### # # # # # ### ### # # ### # ### ### ### # # ##### # # # ### ### # # ### ### # # ### ##### ##### # # ### ####### ### # ###
# #   # # #     # # # # #   #   # # #   # #   #   #   # # #     # # # #   #   # # #   #   # # #   #     #     # # #   #       #   # #   #
# # # ### # ### # # # ### ### ##### ### # # # # # ### # # ##### ### # ####### # # # # # ### ##### # # ### ### ##### # ##### ### ### # # #
# # # #   # #   # # # #     #     #   # # # # # # # # # #     #   # #       # # # # # #   #     # # #   #   #   #   #     #   #   # # # #
# # # ### ##### ### # # # # # ### # # ### # # ##### ##### ####### ### # ### # # # ##### ### # # # # # ### # # # ### ### ### ### ### # # #
# # # #   #       # # # # # #   # # #   # # #           #       # #   #   # # # #     # # # # # # # #   # # # # #     #   # # #   # # # #
# # # ### # ### ### # # # # # ### # ### ### # # ######### # # # # ### # # ### # ### # # # ### # # # # # ### # # ### # ####### ### ### ###
# # # #   # #     # # # # # #   # #   #   # # #         # # # # # #   # #   # #   # # #     # # # # # #   # # #   # #           #   #   #
# ### # # ### # ######### # # ### # # # # # # # # # # # ##### # # ### # # # # # # ######### ### # ######### ### ### # # ### ######### # #
#   # # #   # #   #       # #   # # # # # # # # # # # #     # # # #   # # # # # #         #   # #         #   #   # # #   #         # # #
# ##### # ##### # ### # # ### # # # ### # # ##### # # # ### ##### ### # ####### ####### ### ##### # # # ### ### # ### # # ### ####### # #
#     # # #     # #   # #   # # # #   # # #   #   # # #   #     #   # #     #         #   #     # # # # # #   # #   # # #   #       # # #
# ####### # # # # ### # # ### ### # # # # # # ### # # ### ######### # ### ##### # ##### # # # # # # # ### # # # ### # # # ####### ### # #
#       # # # # #   # # #   #   # # # # # # #   # # #   #         # #   #   #   #     # # # # # # # # # # # # #   # # # #       #   # # #
# ### ### # # # # ### # # ### # # # # # ####### ### ### ########### # # ####### # ### # # # ### # # # # # ### # # ### # ##### # ### #####
#   #   # # # # #   # # #   # # # # # #       #   #   #           # # #     #   #   # # # # #   # # #       # # #   # #     # #   #     #
# # ##### ##### # ### ### # # # ##### # # # ### ### # # # ### ####### ##### # # # # ####### ### # # # # # # # # # ### ### # # ###########
# #   #     #   #   # # # # # #     # # # #   #   # # # #   #       #     # # # # #       # #   # # # # # # # # # #     # # #           #
# # ##### ##### # ### # # # # # # # # # ### ##### # ####### # ### # # ### ### # # # ##### ##### # # ### # # # # ### # # # ##### # ##### #
# #   #     #   #   # #   # # # # # # #   #     # #       # #   # # #   #   # # # #   # #     # # #   # # # # #   # # # #     # #     # #
# # # # # # ### # # ### # # # # ##### # # # # # ### # # ##### ####### ####### ### # ### ########### # # # # # # # ### # ######### ##### #
# # # # # # #   # #   # # # # #     # # # # # #   # # #     #       #       #   # #               # # # # # # # # #   #         #     # #
# ####### # # # ### # # # ### # # # # ### ### ### # ####### # ### # # ####### # ### ### ################# ##### ##### ### # ### # # # # #
#       # # # #   # # # #   # # # # # #     #   # #       # #   # # #   #   # # #     #         #       #   # #     #   # #   # # # # # #
# # # ##### ### # ####### # # # # ### ### ### ##### # # # # # # # ####### ######### # # ######### ####### ### ##### # # ### ### ### # # #
# # #   #   #   #     #   # # # #   # #     #     # # # # # # # #                 # # #               #           # # #   #   #   # # # #
# # # ##### ### # ##### # # ### # ####### # # # ######### ##### ### ### ### ####### # # # # ##### ### ##### ######### # ### # ###########
# # # #   # # # #     # # #   # #     #   # # #         #   # #   #   #   #     #   # # # #     #   #     #       # # #   # #           #
# # # ### # # # # ### # # # # # # ##### # # # # # ####### # # # # ### # ##### # ### ### # # # # ########### # ##### # # ### # # # # #####
# # # #       # #   # # # # # # #     # # # # # #       # #   # #   # #     # # #     # # # # #           # #       # #   # # # # #     #
# # ##### # # ### # ### ### # # # ### # # # # # # # # ############# # ### ### ##### # # ### # ######### # # ### ##### # # # # # # ### # #
# # #   # # # #   #   # #   # # #   # # # # # # # # #             # #   #   #     # # #   # #         # # #   #     # # # # # # #   # # #
# # # # # # # # # # # # ### ### # # # # # # # ### # # # # ### # # # # # ##### ##### # # # # # ### # ####### ##### ##### # # ##### # # ###
# # # #   # # # # # # # #     # # # # # # # #   # # # # #   # # # # # #   #       # # # # # #   # #       #     #     # # #   #   # #   #
# # ### # # # ### # # ### # # # # # # ### # # # # # ### ####### ### # # # # # # ##### ### # # ### # ### ### ### # ####### # ####### # ###
# # #   # # #   # # #   # # # # # # #   # # # # # #   #       #   # # # # # # #     #   # # #   # #   #   #   # #   #   # #       # #   #
# # ### # # # ### # # # ### ##### # # # # # # ### # ### # # # # ##### ####### ### ### # # ####### # # # # # # # # ### ### # # # # ### ###
# #   # # # #   # # # # # #     # # # # # # #   # #   # # # # #     #   # #     #   # # #       # # # # # # # # #       # # # # #   #   #
# # # # # ### ##### # # # # # # # # # # ### # # # ##### # ### ### # # ### ### # # # # ### # ######### ####### # # # # # ##### ### #######
# # # # # #       # # # #   # # # # # #   # # # #     # #   #   # # #       # # # # # #   #         #       # # # # # #     #   #       #
### # # # # # ##### # # ### # ##### ######### ### ############### ### # # ### # ##### ### # ######### # #################################
#   # # # # #     # # # #   #     #         #   #       # # #   #   # # #   # #     #   # #         # #                               # #
# # ######### ##### # # ### ############# ### ########### # # ########### # ### # ####### # ##### ### # # # ####### ### ### ######### # #
# # #             # # # #               # #                             # #   # #       # #     #   # # # #       #   #   #         #  x#
#########################################################################################################################################
