#########################################################################################################################################
#o  # #                                                           #                                   # # #                   #     # # #
# ### # ####### # # # ####### ####### ### ### ######### ##### ####### ############# ######### ##### ### # # ########### ### ### ##### # #
#   #         # # # #       #     # #   #   # #       #     # # #   # # #   #     #         # #   #                   #   # #   #     # #
# ### ##### ### # # ### # ##### ### ########### ### ########### # ### # # ### ##### ### # ##### ########### ### ####### # # # ### ##### #
#         #   # # #   # #     #       #     #     #   # # # # #   #   #       # #     # #       #         #   #       # # #           # #
# ####### # ######### # # ############# ##### ######### # # # # ### ### ##### # ##### # # ####### ############################### # ### #
#       # #         # # #                 #   # # #                         #       # # #   #                                   # #     #
# ### ##### ########### # # ### ### # ##### ### # # ############# ### ########### # ##### ### ####### # ####### ##### ####### # # # # ###
#   #     # #         # # #   #   # # #               # #       #   #   # #     # #     # # #       # #       #     #       # # # # #   #
# # ### ##### ############# # ##### ### ##### ##### # # # ##### ### ##### # ##### ######### # ### # # # ##### ### ######### ####### ### #
# #   #         #         # #     #         #     # #       # #   #             #               # # # #     #   #         #       #   # #
# # ####### # # # ################### ####### ### # ##### ### ########### ##### # # ### ##### # ######### ############### # ##### # #####
# #       # # #               # # # #     #     # #     #               #     # # # # #     # #         #               # #     # #   # #
# # # # ######### ##### ### # # # # ##### ### # ### # ### ### ##### # ### # # ####### ##### # # # # # ##### ########################### #
# # # #         #     #   # #           #   # #   # #   #   #     # #   # # #             # # # # # #     #             #               #
# # # ######### # # ##### # ##### # ############# # ### # # ##### # ### ####### # # ################# # # ####### # ### # ########### ###
# # #         # # #     # #     # #             # #   # # #     # #   #       # # #                 # # #       # #   #             #   #
# ### # ### # # # ### ### # # # # # # ### # # # ####### # ##### ##### ### ### ##### # # ####### ### # # ##### ######### # # # # # ##### #
#   # #   # # # #   #   # # # # # # #   # # # #       # #     #     #   #   #     # # #       #   # # #     #         # # # # # #     # #
# # # # # # # # # # # ### ##### ################# ####### # ####### ##### ############# ### # ####### # # ##### # ####### # # ##### #####
# # # # # # # # # # #   #   # #       # #       #       # #       #     #       #     #   # #       # # #     # #     #   # #     #     #
# # # # # ##### # ##### ##### ######### # ##### # # ### # # ### ####### ##### # # ### # # # # # ####### ##### # # ######### # ### # # # #
# # # # #     # #     #                       # # #   # # #   #       #     # #     # # # # # #       #     # # #       #   #   # # # # #
# ### # ######### # ### # ### ##### ####### # ####### ####### ################### # ####### # ################### # # ### # # # # # # ###
# #   #         # #   # #   #     #       # #   #   # #     #             #     # #       # #       #           # # #   # # # # # # #   #
# # # # # ### # ### # # # ### # ##### # # # ##### ##### ##### ######### ### ##### ### ############### ########### ######### ##### # ### #
# # # # #   # #   # # # #   # #     # # # #                 #       # #         #   #     #   #   # #           #   #   # #     # #   # #
# # ### # ### ########### ### # ####### ### ##### ######### # # # ### ####### # # # # # ### ### ### # ######### ##### ### # #############
# # #   #   #           #   # #       #   #     #         # # # #           # # # # # #       #               #       #   # #         # #
### ### # # ############# ### # # # ### ### # ### ##### # # # # # ### ### # ######### # ####### ######### ############# ##### ######### #
#   #   # #             #   # # # #   #   # #   #     # # # # # #   #   # #         # #                 #   # #     #       #           #
####### ### # ##### # ##### # ##### ### ### # ### # # # ### ##### ####### ##### ### # ####### # ### ##### # # # ##### ####### ### #######
#         # #     # #     # #     #   #   # #   # # # #   #     #       #     #   # #       # #   #     # #         #           # # #   #
### ### ### ######### # # ### ##### # # ### # # # # # # # ### # # ##### # ############# # # # ### # ####### # # # # # ########### # # ###
#   #     #         # # #   #     # # #   # # # # # # # #   # # #   # # #             # # # #   # #       # # # # #             #     # #
##### # ### # ##### # # # ##### # ##### ##### # # # # ### ##### # # # ### ############# # ### ### # ##### ### ######### ### # # # ### # #
#     #   # #     # # # #     # #     #     # # # # #   #     # # #     #             # #   #   # #     #   #         #   # # # #   #   #
# ### # # ### ### # ####### ### ### ### ### # # ### # ##### # # ### # ### ##### # # ### ##### ##### ####### # # ##### ############# # ###
# #   # # #     # #       #   #   #   #   # # #   # #     # # #   # # #       # # # # #     #     #       # # #     #       #     # #   #
# # # # # # # # # # # ### # # ### ##### ### # ##### ########### # # # ### # # ##### # ######### ##### ### ### # ### ########### ####### #
# # # # # # # # # # #   # # #   #     #   # #     #           # # # #   # # #   #       # #   #     #   #   # #   #         # #       # #
# # # # # # # ### # # # # # # ######### # # # ### # # ##### ### # ##### # # ##### # ### # # ### ############### ### ### # ### # ### # ###
# # # # # # # #   # # # # # #         # # # #   # # #     #   # #     # # #   # # #   #       #               #   #   # # #       # #   #
### # # # # # ### # # ######### ### # ######### # ### ##### ####### # ##### # # ### # # # ########### # # ##### ##### # # # ##### # # # #
#   # # # # # #   # #         #   # #         # #   #     #       # #   #   #     # # # #           # # #     #     # # #       # # # # #
### # # # # ##### # # ######### ### ##### ##### # ### ######### # # ### # # ######### # # # ####### ######### ### ########### ### # # ###
#   # # # # #     # #         #   #     #     # #   #         # # #   # # #         # # # #       #         #   #           #   # # #   #
# # # # # # # # ### # ### ####### ######### # # ##### ####### ##### ##### # # ### ##### # # ##### # # ### # # ##### # ### ### ####### # #
# # # # # # # # #   #   #       #         # # #   #         #   # #     # # #   #     # # #     # # #   # # #     # #   #   # #     # # #
# ### # ####### # # # ####### # # ### ##### ### # ### # ##### ### ############### ####### # ### ##### # # ### # ##### ##### ### ####### #
# #   #       # # # #       # # #   #     # # # #   # #     # #                 #       # #   #     # # #   # #     #     # #         # #
# ### # ### ##### # # ##### # # ##### # ##### # # # # # ### # # ################### # # # # # # ##### # # # ### # ### ####### ####### ###
# #   #   # # #   # #     # # #     # #       # # # # #   # #                     # # # # # # #     # # # #   # #   #   #         # #   #
# ### # # ### ### ### # # ### # # # # # # # ### # # # ### # ######### ####### ############### ####### ### ### ######### # ##### ### #####
# #   # #     #     # # #   # # # # # # # #   # # # #   # #         #       #   # # #       #     # #   #   #         #       #   #     #
##### # # # ### # ### # ### # # # ### # # ####### ### # ##### # # # ######### ### # # ### ##### # # ##### # ##### # # ### # ####### #####
#     # # # #   #   # #   # # # #   # # #   #   #   # #     # # # #       #             #     # #       # #     # # #   # #   # #       #
# # # # # ##### # ### # ##### # # ##### ##### ########### # # ### # ### # # # # # # # # ################# # # ################# # ### ###
# # # # #     # #   # #     # # #     #         #       # # #   # #   # # # # # # # # #   #             # # #       #         # #   #   #
# # # ### # # # # # ### # # ####### # ##### ##### ### # ### # # # # # # ######### # ### ### ### ######### # ##### ### ####### # # ### # #
# # # #   # # # # #   # # #       # #     #         # #   # # # # # # #       #   #   #       #         # #     #           #       # # #
### # # # ### # # # ### # # ##### # ################# # # ### # # # ### ### # ### # # ############# # ######### ########### ####### #####
#   # # # #   # # #   # # #     # #                 # # #   # # # #   #   # # #   # #             # #         #           #       #     #
# # # # # # ### # # # ### ### ##### ### # ### # ##### ########### # ####### ### # # ######### # # ########### ### ##### ##### # ### # ###
# # # # # # #   # # # #     #     #   # #   # #     #           # #       #   # # #         # # #           #   #     #     # #   # #   #
# ### ##### # # # # # ### # ##### # # # # # # # # # # ### # ####### ### ### # # # # ### # ##### ####### # # # ######### ### # # ### # ###
# #     #   # # # # # #   #     # # # # # # # # # # #   # #       #   #   # # # # #   # #   # #       # # # #         #   # # # #   #   #
# ### ### ### # # # ### # # # # ##### # ######### ### # # # # # ### # ########### # # # # ### ### # ############# # # # ####### ### # # #
#   #   # #   # # #   # # # # #     # #         #   # # # # # #   # #         #   # # # #   # # # #   # #   #   # # # #   #   #   # # # #
# # # # ### ### ### # # # # ### ### ### ### ####### # ### ##### # ##### ######### # # ##### # # ####### # ### ######### ### ##### # # ###
# # # #   # #     # # # # #   #   #   #   #       # #   #     # #     #     #     # #     #                       #   #         # # #   #
# # # # ### # # # # # # # # ### ### # # # # ### ### ##### ####### # # ### # ### # ### ### # # ##### ####### # # ### ### ### #############
# # # #   # # # # # # # # #   #   # # # # #   #   #     #       # # #   # #   # #   #   # # #     #       # # #       #   #             #
# ##### # # # # # # # ### # ### ### # # # # # # # ##### # ### ##### # # # ### # # ### # # # # # # ### ##### ######### ### ##### #########
#   #   # # # # # # # #   #   #   # # # # # # # #     # #   #     # # # #   # # # #   # # # # # #   #     #         #   #     # #       #
# # ### ### ### # # ### ### ######### # ### # # # # ##### # ########### # # # # # ### # ### ### # # # # ### ####### ############# ### ###
# # #     # #   # #   # #           # #   # # # # #     # #           # # # # # #   # #   #   # # # # #   #   #   #       #         #   #
# ##### ### ### # ### ##### ### # ##### ##### # # # # ##### # ##### ### # # ### # # # # ### ### ########### ### ### ####### ########### #
# #       # #   #   # #       # #     #   #   # # # #     # #     # #   # #   # # # # #   #   #           #       #                   # #
# # # # # ##### # ### # ### ### # # ##### ### # ##### ### # # ######### ######### # # # # # # # ### ####### ########### # ### ##### # ###
# # # # #   #   #   # # #     # # #     # #   #     #   # # #         #         # # # # # # # #   # #     #     #     # #   #     # #   #
# ### # # ### # # ##### # # # # # ##### # ### # # # # # # # # # ### # # ### ####### ### # # # # ##### ########### ### # ### # # ### # # #
# #   # # #   # #     # # # # # #     # #   # # # # # # # # # #   # # #   #       #   # # # # #                     # #   # # #   # # # #
# ### # # ##### # # ### # # # # ##### ### # ### # ### ##### # ### # # # ##### ##### ### ### ### # ### ### ##### # # ### ##### ### #######
# #   # # #     # #   # # # # #     #   # #   # #   #     # #   # # # #     #   # #   # #     # #   #   #     # # #   # # # #   #     # #
# ### ### ### # # ####### # # # ### ####### ### ##### ### # # ##### ### # ####### # ### ### ### # ### # ### ### ##### # # # ########### #
#   # #   #   # #     #   # # #   #       # #       #   # # #     #   # #         # #     # #   #   # #   #   #     # #   #           # #
# ### # ### # # # ##### # # # # # # # ##### # # # ##### # # # # ####### # # ##### # ######### # # ### # ############# # # # ########### #
# #   # #   # # #     # # # # # # # #     # # # #     # # # # #   #   # # #     # #     #     # #   # #             # # #             # #
# ### ### # # ### # ### # # ### ############### # # # # # # # # # # ##### ####### # ### ##### # # # ########### # # # ### ### ######### #
# #   #   # #   # #   # # #   #       #   # # # # # # # # # # # #       #       # #   # #     # # #           # # # #   #   #           #
# ### ### # # ### ##### # # # # ####### ### # # # ##### # # # # ##### # # # ### # # # ### # ### # # # # ### ####### # ### # # # # # #####
# #   #   # # #       # # # # #               # #     # # # # #     # # # #   # # # #   # # #   # # # #   #       # #   # # # # # #     #
##### ##### # # # # # # ### # # # # # ### # ### # # ########### # # # ### # # # # # # # # ##### # ### ### ######### # # # # ### # # # # #
#     #     # # # # # # #   # # # # #   # #   # # #         #   # # #   # # # # # # # # # #     # #     #         # # # # #   # # # # # #
### # # ### # ### # # # ### ### # ### ##### # # # ### ### ##### ### ### # ##### # # # ### # # # # ### ####### # ####### ### # ### ##### #
#   # # #   #   # # # # #     # #   #     # # # #   #   # # # #   # # # #     # # # # #   # # # #   #       # #       #   # #   #     # #
### # # # # # ##### # ### # ### # # # # ######### # ####### # # # ### ####### ### # # ### # # # # ### # # ### # # # # ### # # # ##### # #
#   # # # # # #     #   # #   # # # # #         # #           # #           #   # # #   # # # # # #   # #   # # # # #   # # # #     # # #
##### # ### # # # # # ##### ##### # ### ######### # # # ######### # # ##### ####### ### # # # # # # # # # ################# # ##### #####
#     # #   # # # # # #         # #   #       #   # # #         # # #     #       #   # # # # # # # # # #                 # #     #     #
# # # # ### # # # # ### ### ### # ### # # # # # # # # ### # ### # # # ### # # # # # # # # # # ### # # # # ### # # ### ####### # # # #####
# # # # #   # # # # #   #     # #   # # # # # # # # #   # #   # # # #   # # # # # # # # # # # #   # # # #   # # #   #     #   # # #   # #
### ### # # ### # ### # # # # # # # # # # # # # # # # # # # ##### # # # ####### ### # # # # # # # # # # ### # ### ### # ##### # ### ### #
#   #   # # #   # #   # # # # # # # # # # # # # # # # # # #     # # # #       #   # # # # # # # # # # #   # #   #   # #     # #   #     #
# # ### ### ### # ####### # ### # # ### # ### ##### ### # ##### ##### ### ### ########### # ### # # ### # # # # ####### # # ### # ##### #
# # #   #     # #   #     #   # # # # # #   # # #     # # #   #     #   #   #     #     # # #   # # # # # # # #     # # # #   # #     # #
######### # ### ##### # # # # # # ### ### ### # # # ####### ########### # ######### ####### # # # # # # ### # # ##### # ### ### # ### # #
#         #   #     # # # # # # #       #   #   # #   # #             # #   #             # # # # # #     # # #       #   # #   #   # # #
# # # # # # # # # # # # # # # # ### ############# # # # # ### # ##### ####### ##### # ##### # ### # # # # # # # # ##### ##### # # # ### #
# # # # # # # # # # # # # # # #   #             # # #       # #     #             # #     # #   # # # # # # # # #     #     # # # #   # #
# ### ### # ### # ### # # # # # ### # ######### # # ##### # # ### # # ##### ######### ##### ##### ### # ########### # # # ##### # ### # #
# #     # #   # # #   # # # # #   # #         # # #     # # #   # # # # # #         #     #     # #   #           # # # #   #   #   # # #
# ### # # # ### # ### # ### # # # # # # ### # # ### # # ### # ######### # ### # # # # ####### ### # # # # ##### # ##### # # # # # # # # #
# #   # # #   # # # # #   # # # # # # #   # # # #   # #   # #               # # # # #       #   # # # # #     # #     # # # # # # # # # #
### # ### # ### ### # # # # # # # # # ######### ### # # # # # # # ################# ######### ##### # # # # # ### ##### # ### # # # # # #
#   # #   # #   #     # # # # # # # #         #   # # # # # # # #             #   #         #   #   # # # # #   #     # #   # # # # # # #
# ### # # # ### ### # # ### # # # # # # # ######### # # ##### # # # ########### ### # # # # ### ### # # # # # ### ### # # ##### # # # # #
# #   # # #   # #   # # #   # # # # # # #         # # #     # # # #               # # # # #   # #   # # # # #   #   # # #     # # # # # #
# # # ### # # ### ### ####### # # # # # # # # ### # # # # # # # # # # # ### ##### ####### ############### # ### # # # # # # ### # # # # #
# # # #   # #   # #     #     # # # # # # # #   # # # # # # # # # # # #   #     #       #     # #       # #   # # # # # # # # # # # # # #
# ### ### ### # # # # ##### # ##### # ### # ########### # ### # # # # # ### ############# ### # ### ### ### ### # ########### ### # # # #
# # #   #   # # # # #   #   #   #   #   # #           # #   # # # # # #   #   #         # # # #       #   #   # # #             # # # # #
### # ### # # ##### # # # # # # # # ### ### ##### ### # # ### # # ### # ### ### ### ####### ### ##### ##### ### ### ##### ### # # # #####
#       # # # #     # # # # # # # #   #   #     #   # # #   # # #   # #   #       # #       #       #     #   #         #   # # # #     #
##### # # ### ##### # ### # # ##### # ##### # ##### ### ####### ####### # ####### ### ####### ####### ### # ##### ### # ########### # ###
#   # # # #   #     # #   # # #     #     # #     #   #       #       # #       #   #     # #       #   # #     #   # #         #   #   #
# # # ####### # ### # ### ### ##### # ### # ### # ### ### # ### ### ##### ### ####### ##### # ########### # ####### ### # # # ###########
# #       #   # #   # #     # #     #   # #   # #   #   # #   #   #     #   #                           # # #     #   # # # #           #
# # # ##### # # # # # # # # # # ### # # # # ### # ### # ######### # ### # # ########### # ### # # ##### ##### ####### # # ### ##### # ###
# # #     # # # # # # # # # # # #   # # # #   # #   # #         # #   # # #   # #     # #   # # #     #             # # # # #     # #   #
### # ################# # # # # ### ### # # # # # # # ######### # ####### # ### # ### ####### ################### # ##### # ####### ### #
#   #     # # #         # # # # #     # # # # # # # #         # #     # # #         #       #                   # #     #     # # # # # #
##### # ### # ##### ### # # # ### # ##### # ### ##### # ##### ######### ### ### ### ### ######### # ####### ### ### ### # ##### # ### ###
#     #       #     #   # # #   # #     # #   #     # #     #           #     #   #   #         # #       #   #   #   # #              x#
#########################################################################################################################################
