#########################################################################################################################################
#o                      # #   # #   #                                                                 # # #   #               #   #     #
# # # # # ####### ####### # ### # ### ##### ### # ##### # ### ############### # ####### ##### ######### # # ### ############# # ### #####
# # # # #   # # # #   #                   #   # #     # #   #               # #       #     # # # #         #     # #   #   # #         #
# # # # ### # # ### ### ### ######### # # # # ##### ##### ##### # # # ### ##### ############### # # ######### ##### # ### ##### #########
# # # #   #               #         # # # # #     # #   #     # # # #   #     #                       # #       #   #       #           #
# ### # # ### # # ####### ####### ### # ############# ### # # ##### # # ####### # # ### # ##### ####### # ### # # ### ####### ##### ### #
#   # # #   # # # #     #       #   # #                 # # #     # # #       # # #   # #   # #       #     # #   #               #   # #
# # # ### ##### ### ################### ############### # ### ### ### # ### # ####### # ##### ######### ########### ####### ### ### # ###
# # #   #     #                       #               # #   #   #   # #   # #       # #                       #           #   #   # #   #
##### # # ##### ### ##### # # ### # ##### # ######### # ############# # # # # ########### ######### # ####### # ########### # # # ### # #
#     # #     #   #     # # #   # #     # #         # #             # # # # #           #         # #       #             # # # #   # # #
### # ### ##### ### ##### # ### ### ### # # ### ############### ####### ### ### # ######### # # # # ####### # ### # ### # # # # # ### # #
#   #   #     #   #     # #   #   #   # # #   #               #     #     #   # #         # # # # #       # #   # #   # # # # # # # # # #
# # # ### # # # ##### # # # # # # # # # # # ### # # # # ### # ##### ### ### ######### ##### # # # # # ############# ### ########### #####
# # # #   # # #     # # # # # # # # # # # #   # # # # #   # #     #   #   #         #     # # # # # #             #   #     #     #     #
### # # # # # # # ########### # ### # # ### # # # # ####### ### ### ### ### # # ####### # # # # ### ### # ####### # # ##### # ##### ### #
#   # # # # # # #           # #   # # #   # # # # #       #   #   #   #   # # #       # # # # #   #   # #       # # #     #           # #
### # ### # # ### # # # # # # # ### ### # ### # # ### # # ##### ####### ##### ####### ##### ### # # ####### # # ### # # ##### ####### # #
#   #   # # #   # # # # # # # #   # #   #   # # #   # # #     #     # # # # #       #     # #   # #       # # #   # # #     #       # # #
# # ### # # # # # # # # # # # # ### ##### ##### ### # ### # ##### ### ### # ####### ####### ##################### # ##### ### # ####### #
# #   # # # # # # # # # # # # # # # #   #     #   # #   # #     # # # #           #       #                     # #     #   # #     # # #
### ### # ### # # ### # ##### # # ### ### ######### # # # ######### # # ########### # ########### ##### # ### ####### ##### ####### # # #
#   #   #   # # #   # #     # #         #         # # # #   #                     # #           #     # #   # # #   #     #       # # # #
### ### # # ### ### # # # ### # # ### # ################# ### ############# # # ########### ####### # ##### ### # ### ### ########### ###
#   #   # # #     # # # #   # # #   # #                 #                 # # #         # #     # # #     #         #   # #             #
### ### # # ### # ### # # ### # # # # # ### ##### ####################### ##### # ####### ####### ####### ################# ####### #####
#   #   # #   # #   # # #   # # # # # #   #     #       #             # #     # #                       #   #                     #     #
### ### # ### # # ### # # ### # # ### # ### ####### ##### ### ### ##### ##### ################### # ##### # # ##### ### ####### ### #####
#     # #   # # #   # # #   # # #   # #   #       #         #   #           #       #           # #     # #       #   #       #   #     #
# # # # # ### # ##### # ##### # # ### # ### # ### ##### ### # ### ### # # ### ### # # ####### ##### ### ### # # # ### # ### ### # ### # #
# # # # #   # #     # #     # # #   # #   # #   #     #   # #   #   # # # #     # #         #     #   #   # # # #   # #   #   # #   # # #
# # # # # ### # # # ### # ### # ##### # # ### ##### # # ######### # ### # ### # # # # ### ##### ##### ##### # ### # # # # ### # # # ### #
# # # # #   # # # #   # #   # #     # # #   #     # # #         # #   # #   # # # # #   #     #     #     # #   # # # # #   # # # #   # #
# # ##### # ########### ### ### # ####### ### # ### # # # ### ##### ##### # # ##### # ####### ### ####### ### # # ##### # # # ######### #
# #     # #           #   #   # #       #   # #   # # # #   #     #     # # #     # #       #   #       #   # # #     # # # #       # # #
# # # ### # # # # # ### ### ### ### ### ##### # ##### ### # # # # # ### # # # ####### ##### # ##### ####### # ####### ### ### # ##### ###
# # # #   # # # # #   #   #   #   #   #     # #     #   # # # # # #   # # # #       #     # #     #       # #       #   #   # #         #
# # # # # # ### ### ##### ### # ### # # # # # # ######### ### # ##### ### # ### ### ### # # # # ######### # # # # # ### #################
# # # # # #   #   #     #   # #   # # # # # # #         #   # #     #   # #   #   #   # # # # #         # # # # # #   #       #   #     #
### # # # ##### # ########### # ########### # # ### # ### # ### ### # # ### ####### ##### # # ### ##### # # ##### # ### ### # # ### #####
#   # # #     # #           # #         # # # #   # #   # # # #   # # #   #       #     # # #   #     # # #     # #   #   # #           #
# # # # # # ### # ########### # # ### ### ##### ####### # # # # # ######### ####### ##### ### ### # ### ########### ######### # ### # ###
# # # # # #   # #           # # #   #         #       # # #   # #       # #       #     #   #   # #   #         # #         # #   # #   #
# # # # ### ### # ##### ##### # # # # ### ####### ########### ### ####### # # # ### ####### # ### # ##### ####### # # ### # ### # # # # #
# # # #   # #   #     #     # # # # #   #       #           #   #         # # #   #       # # # # #     #         # #   # #   # # # # # #
# # # # ### # # ##### # # # ### # ### # # # ### # # ### ### ##### # ####### ### # # ##### # # # ### # # # # ####### # # # # # # # # ### #
# # # #   # # #     # # # # #   #   # # # #   # # #   #   #     # #       #   # # #     # # #     # # # # #       # # # # # # # # #   # #
# ### # ### ### # # # # # # # # # # # ### # # # ##### ####### ######### ################# ### ######### # ######### # # ### # # # # # # #
# #   #   #   # # # # # # # # # # # #   # # # #     #       #         #       #         #   #     #   # #         # # #   # # # # # # # #
### # # ### # # # ##### ##### ### # # ### ### # ### ### # ####### ### # # # ### ### # ##### # # ### ##### # # # ### # # ### ##### # # ###
#   # #   # # # #     #     #   # # #   #   # #   #   # #       #   # # # #       # #     # # #         # # # #   # # #   #     # # # # #
# ### # ### # # # ####### # # # # # # # # # # # # # # ### ### ### ####### ### # ##### ############### ############### # # ############# #
# #   #   # # # #       # # # # # # # # # # # # # # # # #   #   #       #   # #     #     #         #           #   # # #           #   #
### # # ### # # # # # # # ### # # ### # # # # # # # # # # # # ### # # ########### ### ##### ####### # # # ### ### ##### ##### ####### ###
#   # #   # # # # # # # #   # # #   # # # # # # # # #   # # # #   # #           #   #             # # # #   #         #     #           #
##### # ### # # # # ####### # # # # ### # # # # # # # # ### # ### # # ##################### # # ##### # ####### ########### # ##### # ###
#     #   # # # # #   #   # # # # #   # # # # # # # # #   # #   # # #                     # # #   # # #   #   #   #       # #     # #   #
### ### ### ##### # ### ### ##### ##### # # # # # # # # ######### ### ####### # ### ### ### # # ### ####### ####### #####################
#   #     #     # #       #     #     # # # # # # # # #         #   #       # #   #   #   # # # #     # #                               #
### # # # # ### # ####### ######### ##### # ### # # # # ##### # # # # # # # # ##### # ##### ##### ##### # ### ############# # ### # #####
#   # # # #   # #       #         #     # #   # # # # #     # # # # # # # # #     # #     # #       #       #             # #   # # #   #
######### # # # # # ####### ### ### # ##### ### ### # # # ####### ### # # # # ### ##### ##### ####### ##### # # ##### ####### # ##### ###
# # #     # # # # #       #   #   # #     # #     # # # #       #   # # # # #   #     #                   # # # #   #       # #   #     #
# # ##### # ##### # ##### ##### # # # ####### # # ### # # ########### # # # ##### ############# ### # # # ####### ########### ##### ### #
#   #     #     # #     #     # # # #     #   # #   # # #           # # # #     #             #   # # # #                   # #   #   # #
### ##### # # ### # # # # # # # ### # ### ### ### # # ### # # ######### # # # ### # # # # # # # ### ### # ### ### ### # ####### ### #####
#   #     # #   # # # # # # # #   # #   # #     # # #   # # #         # # # #   # # # # # # # #   #   # #   #   #   # #               # #
### ### # # # # # # ### ########### # # ##### # # ### ### ### # ### # # ### # ##### # # # # # # # # ##### # ####### ################# # #
#       # # # # # #   #     #     # # #     # # #   # #     # #   # # #   # #     # # # # # # # # #     # #       #                 #   #
# ### # # ### # # # # # ##### ### ########### ### # ### # # ### ######### ### ### # # # # # # # # # # ### ### # # # # ### # # # ##### # #
# #   # #   # # # # # #         #           #   # # #   # #   #         #   #   # # # # # # # # # # # # #   # # # # #   # # # #     # # #
# ### # # ### # # # ####### # # ########### # # ### ### ### ############# # # # # ### # ##### # ### # # # # ### # # ####### ### ### ### #
# #   # #   # # # #       # # #           # # #   # #     #             # # # # #   # #     # #   # #   # #   # # #       #   #   #   # #
# # # ### ### # # # ### ### # ####### # # # ####### # # # # ### ##### # ############# # ##### # ##### # # # # ### # ####### # # # # # # #
# # # #     # # # #   # #   #       # # # #       # # # # #   #     # #             # #     # #     # # # # #   # #       # # # # # # # #
# # # # # # # ### # # # ### # ### ### ############# ### # # ### # # ####### # # ### # ### # # # # ### # ### # # # # # ### ##### ### ### #
# # # # # # #   # # # #   # #   #   #             #   # # #   # # #       # # #   # #   # # # # #   # #   # # # # # #   #     #   #   # #
# # # # # ### ### # ### # ##### ##### ############# # # # ### ### ####### ### # ### ####### ##### # # # # # # ##### # ####### # # # #####
# # # # # #   # # #   # #     #     #             # # # #   #   #       #   # #   #       #     # # # # # # #     # #       # # # #     #
### # # # ### # # # ##### # # ####### # # # ####### ##### ### ### ### ########### ####### # # # # # # # ##### ####### # ##### # # # # ###
#   # # # #     # #   #   # #       # # # #       #     #   #   #   #           #       # # # # # # # #     #       # #     # # # # # # #
# # # # # ### ##### # ### ### ### ##### ### ### ### ### ### # # # ### # # # # # ################# ##### ### # # # ##### ##### ### # ### #
# # # # # # #   #   #   #   #   #     #   #   #   #   #   # # # #   # # # # # #             # # #     #   # # # #   # #     #   # #     #
### ##### # # ##### # # ##### ##### ####### ### ####### # ### ### # # ##### # # ############# # ####### ##### ### ### ### ### ### ### ###
#       # #       # # #     #     #       #   #       # # # #   # # #   # # # #                       #     #   #       #   #   #   #   #
### ### ### # ##### # ### ### # ########### ####### ####### ### # ### # # # # ### ########################### ### # ############# # ### #
#     # #   #   #   #   # #   #   #       # #     #     # #   # #   # #   # #   #   # # #           # #     # # # #             # #   # #
### # # # # # ### # # ### # # ##### ######### ### # ##### # ### # # ####### # # ##### # # ########### # ####### # # ##### ##### ### # # #
#   # # # # #   # # #   # # #                   # #           # # #       # # #   #   # # #                     # #     #     #   # # # #
# # ### # # # # # # # # # ### # ########### # # # # ######### ### # ### ####### ### ### # # ########### ########### ### # ##### ### #####
# #   # # # # # # # # # # #   #           # # # # #         #   # #   #       #                       #   #       #   # #   # #   #     #
# # # # # # # # # # # # ##### # ##### # ############### ### # ####### # # # ### # # ### ### ### ########### ##### # ### # ### # ### # # #
# # # # # # # # # # # #   #   #     # #     #         #   # #       # # # #   # # #   #   #   #                 # #   # #     #   # # # #
# # # # ##### # # # # # # # # # # # ######### ############### # # ### # ### ### ### ### # ### ################# ####### # ##### #########
# # # #     # # # # # # # # # # # #                         # # #   # #   #   #   #   # #   #                 #     # # #     #         #
# ### ### ##### # ### # ### # ### # # ### ############# ##### ### # # # ### ### # # # # # # # ### # # ####### # # # # ### # ### #########
#   #   #     # # #   # #   #   # # #   #             #     #   # # # #   #   # # # # # # # #   # # #       # # # #     # #   #         #
# # # # # # # # # ##### ##### ####### # ##### # ######### ### # ### # # ### # # ### ### ##### # ### # # # # ########### #################
# # # # # # # # #   #     #         # #     # #         #   # #   # # #   # # # #     #     # #   # # # # #           #   # #           #
# # # ##### # # # # ### ##### # # # # # ### # # ### # # ################# ### ##### ############# ####### # # # ########### # ####### ###
# # #     # # # # # #     #   # # # # #   # # #   # # #                 #   #   #               #       # # # #                     #   #
# # # # # # ### # # # # # # # # # # ####### ### # # # ####### ####### ######### # # # # # ##### # ### ### ### ######### # ##### # # #####
# # # # # # #   # # # # # # # # # #     # #   # # # #       #       #         # # # # # #     # #   # # #   #         # #     # # #     #
##### # # # ### # # # # # ### # # ####### # ####### # ############# ############# # # # # # # ### ##### ##### ####### # ########### # # #
#     # # #   # # # # # # #   # #         #       # #             #             # # # # # # #   #       #   #       # #           # # # #
# # # # ####### # # ### ##### # ####### ### # ### # # # # ####### ### # ####### # # ### # # ##### ####### ##### ### # ####### # # # # # #
# # # #       # # #   #     # #       #   # #   # # # # #       #   # #       # # #   # # #     #             #   # #       # # # # # # #
# ### # ####### # # # # # # # # # # # ##### # # # # # # # # # ##### # # # # # # # # # ### ######### # ##### ### ### # # ### # # # ##### #
# #   #       # # # # # # # # # # # #     # # # # # # # # # #     # # # # # # # # # #   #         # #     #   #   # # #   # # # #     # #
# # # # # # # # ### ### ##### # ##### ####### # # # ### # ### # ### ######### # ### ##### # # ##### ### # # # # ### # # # ############# #
# # # # # # # # #     #   #   #     #       # # # #   # #   # #   #         # # #       # # #     #   # # # # #   # # # #             # #
# ##### # ######### ### ##### # # # ### ##### ### # # # # # # ### # # ### ### ##### # # # # ####### ### ### ##### ### # # ####### # ### #
# #     #       #     # #   # # # #   #     # #   # # # # # #   # # #   #   #   #   # # # #       # # #   #     #   # # #   #   # #   # #
# # # # # # ##### # # # # # # # # # # ### ### ### ####### ##### ### # # ##### # ### # # # # ####### # ##### # ### # ### ##### ##### ### #
# # # # # #     # # # # # # # # # # #   #   #   #       #     #   # # #     # #   # # # # #       #       # #   # #   #           #   # #
# ##### # # ####### ### ### ### # ############### # ### # # ####### # # ### # # # ### # ### # ##### # # ### # ### # ####### # # # # #####
#   #   # #     # #   # #       #             # # #   # # #       # # #   # # # #   # # #   #     # # #   # #   # #       # # # # #     #
# ##### # ### ### # # ##### # # # ### ####### # ### ##### # ################### ### # # ### # ### ### ### # # # # # ### # # # # ##### ###
# #     #   # # #   # #     # # #   #       #     #     # #                   #   # # # #   #   #   #   # # # # # #   # # # # #     # # #
# ##### # ### # ### ##### # # ### ### ##### # # # # ##### # # # # # ####### # # ####### ### # # # # ##### # # # ### ### # # ########### #
# #     #   #   #     #   # #   #   #     # # # # #     # # # # # #       # # #       #   # # # # #     # # # #   #   # # #           # #
# ##### # # # ### # ### ### # # # # # # ### # ### # # ### ### ####### # ##### # # # ### # # # ### # # # ##### # ### ### # # ##### # # # #
# # #   # # #   # #   # #   # # # # # #   # #   # # #   #   #       # #     # # # #   # # # #   # # # #     # #   #   # # #     # # #   #
# # # # ##### # # # # # ### ### # # # # # # # ##### # ##### # ####### ####### # ##### ### ### # # # # ##### # # # ### # # # # # ### #####
# #   #     # # # # # # #     # # # # # # # #     # #     # #       #       # #     #   #   # # # # #     # # # #   # # # # # #   #     #
### ### # # # # # # # ##### ### # # # # ####### ############# ### ### ######### ####### ### # ### # ### ### # # # # ### # # ########### #
#   #   # # # # # # #   #     # # # # #       #             #   #   #       # #       #   # #   # #   #   # # # # #   # # #           # #
# # ### # # ### # # # ### # ### ### # # # ############# # # # ############### ########### # # # # ### # ### # # # # ### ### # ### # #####
# # #   # # #   # # # # # #   #   # # # #       #     # # # #   #   #       #   # #     # # # # #   # #   # # # # #   #   # #   # #     #
# ##### ####### # ##### ### ####### # ### # # # # ### ##### ##### ### ### ### ### # ### ### # # # ### # ####### ### # ##### ##### # ### #
# # # #       # # # #   #         # #   # # # #     #     #   # # # # # # #     #     #   # # # #   # #     # #   # # # # #     # #   # #
# # # # # ### # ### ### ### ### ######### ####### # ####### ### # # # # ### ##### ########### ### # ######### ######### # # # # ### # # #
# # #   #   # # # # #     #   # # # # # # #     # #       # #     # # # # # #             # #   # #         #     #       # # #   # # # #
### ### # ##### # # # ### # # ### # # # ### ### # ### ####### ##### # # # # # ############# ### # ### # # ### ##### #####################
#       #     # #     #     #                 # #   #                                         # #   # # #                              x#
#########################################################################################################################################
