#########################################################################################################################################
#o                                  #                               #                   #   #   #     #             # #     #       #   #
# ############### ### # ######### # # ############# ### ######### ### ############### ### ### ### ##### ##### ####### # ##### ####### ###
#         # #   #   # #         # #               #   #         #           #       #                 #   # # #     # # #     # # #   # #
# # ### ### # ####### ### # ### # # # ### # ######### ####### ############### ########### ############# ### ### ##### # # ##### # ### # #
# #   #             #   # #   # # # #   # #         #       #               #           #                   #     #             #   #   #
# # ### ########################### ########### ####### ### # # ############# ### ### # ####### ####### # ### ##### ############# ##### #
# #   #                           #           #   # # #   # # #         #       #   # #       #       # #         # #     # # #       # #
# # # ################################# ### ### ### # ########### # # ### ##### ### # ### # ############# ######### # ##### # # ### ### #
# # #                   # #           #   #   #                 # # #         #   # #   # #             #     # #                 #     #
# ### # ##### # # ### ### # ####### ####### ####### ### ### # ### # # ### # # ### # ### # ##### # # ######### # # ##### # # # # #########
# #   #     # # #   #             #       #       #   #   # #   # # #   # # #   # #   # #     # # #         #         # # # # #         #
# ### # # ### ### ### ##### # ### # # ####### ##### # ### # ############# ######### ### ### ### # ####### ##### # ### # # # # ##### # ###
# # # # #   #   #   #     # #   # # #       #     # #   # #             #         #   #   #   # #       #     # #   # # # # #     # #   #
# # # ####### ### ### ### # # ##### ##### ########################### # ### ######### ####### # ############# # # # ########### ##### ###
# #         # # #   #   # # # #   #     #             # #           # #   #         #       # #             # # # #           #     #   #
# # # # ####### # # ####### ### ##### ### ######### ### # ####### # # ########### ########### ##### # ########### ##### # ### # #########
# # # #     #     #       #         #   #         #             # # #           #           #     # #         #       # #   # #         #
# # # # # # # # # # # ### ### ### ####### # # # ##### # ########### # ### # ### ############# ####### ### ######### ####### # # ##### # #
# # # # # # # # # # #   #   #   #       # # # #     # #           # #   # #   #             #     #     #         #       # # #     # # #
# # # # # # ##### # ### # # # ### # # ####### ### ####### # ####### # ####### ##### ### ##### # ######### # ### ######### # # ##### # ###
# # # # # #     # #   # # # #   # # #       #   #       # #   #   # # # # # #     #   #   # # #         # #   #         # # #     # #   #
# # ### # # # # # # # ### ####### # # # ##### ####### # ####### ####### # # ### # ### ##### ####### ##### ####### ##### ########### # ###
# #   # # # # # # # #   #       # # # #     #       # #   #   # #     # #     # #   # # #         # # # #       #     # #       # # #   #
# # # ### # # # # # # ##### # ################# # ### ##### ### # ##### # ############# # ########### # ### # ### ##### # ### # # #######
# # #   # # # # # # #     # #                 # #   #                                               #     # # # #     #     # #         #
# ####### ### # # # # # ### ### ######### ##### # ### ##### ####### ### ### ######### # ############# ######### ########### # ### # #####
#       #   # # # # # #   #   #         #     # #   #     #       #   #   #         # #                                   # #   # #     #
# # # ### ### ### # # ##### # # ####### ########### # # # ### ######### # ##### ### ### ### ##################### # ##### ### # #########
# # # # #   #   # # #     # # #       #           # # # #   #         # #     #   #   #   #   #                 # #     #   # #         #
# # ### # # ### # # # # # # ### # ### ### ### ######### ### # ### ##### ##### # # # ####### ### ####### ### # ### ##### # ##### #########
# #     # #   # # # # # # #   # #   #   #   #         #   # #   #     #     # # # #       # # #       #   # #   #     # #     #         #
# # ### ### ##### # # ### # # ### # # ### # # ### ##### ### # # ####### ##### # # # # # ### # # ######### ############################# #
# #   #   #     # # # #   # #   # # #   # # #   #     # # # # #       #     # # # # # #   # # #         #         #                   # #
### ### # ##### # # ##### ### ######### # ####### ####### ######### # ####### ### # ######### # ################### #####################
#     # #     # # #     #   #         # #       #     #           # #       #   # #     # #                     #                     # #
# # ### ####### ### # ### ### # ### # ### ############# ######### # ################# ### # ####### # # ### ##### ### # ############# # #
# # #         #   # #   # #   #   # #   #       #               # #         # #     #             # # #   #         # #     # #   # # # #
### ### ####### ### # # # # # # # # # ### ### # # ### ######### # ##### ##### # ############### ##### # # ### ##### ######### # ### ### #
#     #       #   # # # # # # # # # #   #   # #     #         # #     #     #         #       #     # # #   #     #                     #
# # # # ### # ############# # # # # ####### # ####### # ##### # # ### ### ### ### # ### ############# # ### # # # # ##### ######### # ###
# # # #   # # #         #   # # # #       # #       # #     # # #   #   #       # #                 # #   # # # # #     #         # #   #
### # # # ##### ##### ####### # ### ####### # # ##### # # # # # ### # # # # # ####### ### ########### # ### # # ### # ### # ######### ###
#   # # #           #       # # #         # # #     # # # # # #   # # # # # #       #   #         # # #   # # #   # # #   #         #   #
### # # # ##### ##### ### # ### ############# # ### # # ### # # ######### # ##### ### # # ##### ### ### # ####### # ##### # # ###########
#   # # #     #     #   # # #             #   #   # # #   # # # #     #   #     #   # # #     #       # #       # #     # # #           #
# # ##### ########### # # ### # ##### # ##### # # # # ######### # ### ########### ### # # # ####### # ######### ####### ### # ### ### # #
# # #               # # #   # #     # #   #   # # # #         #     # # #       #   # # # #       # #     #   #       #   # #   #   # # #
# # # ### ### # ####### # # ### ### ### # # # # # # # ##### ### # # ### # ##### ### # ### # # ### ######### ### ############# # # # # # #
# # # #     # #       # # # #     #   # # # # # # # #     #   # # #           #   # #   # # #   #             #             # # # # # # #
# ### # # # # # # ##### # ### # ### ### ########### # # ### # # ##### # # # # ### # # # ####### ####### ##### ####### ####### ### #######
# #   # # # # # #     # # #   #   #   #     #     # # #   # # #     # # # # #   # # # #       #       #     #       #       # # #       #
# # ### # # # # # # ### ### # # ### # ####### ### # # # # ######### # # ##### ### # ### # ##### # # # # ### ### ####### # ##### ##### ###
# # #   # # # # # # # #   # # #   # #           # # # # #         # # #     #   # #   # #     # # # # #   #   #       # #           #   #
##### # # ##### ### # ####### # # # ##### # # ####### ######### ####### ### ##### # # # # # ### # # # ### ### ##### ### ### # # # #######
#     # #     #   #         # # # #     # # #   #   #         #   # #     #     # # # # # #   # # # #   #   #     #   #   # # # #       #
# ### # # ######### # ######### ##### ##### # ### ######### ### # # ### # ########### # ####### ##### ### # # # # ##### # ####### ### ###
# #   # #         # #       #       #     # #             #   # #     # #     # # #   #       #     #   # # # # #     # #       #   #   #
# # # # # # ### ##### ######### # # ### # ##### ##### # ############### # ##### # ##### # # ######### ### # # # #########################
# # # # # #   #     #       #   # #   # #     #     # #               # #             # # #   # #   # # # # # #         #     #     # # #
##### # # # # # # # ### # # # # # # # ### # ### # # # # ################# ### ##### # ### ### # # ##### ####### # ####### ##### ##### # #
#     # # # # # # #   # # # # # # # #   # #   # # # # # # # #           #   #   # # #   # # #       #         # # #       #   #   # # # #
### # # ### # # ### ### # # # # ### # # # ##### ### # # # # # ### # # # ### # # # ####### # ##### ### ############# ####### ### ### # # #
#   # #   # # # #     # # # # #   # # # #     #   # # # # #     # # # #   # # #         #       #                                       #
# # # # # # # ### # ##### # ### # # # ### # ######### # # # ### # # # ####### # ############### # ##### ### ################# ##### # ###
# # # # # # #   # #   #   #   # # # #   # #         # #       # # # #       # #     #         # #     #   #                 #     # # # #
### # # # ### # ### ##### ### # ### # ### ##### ### # # ##### ##### # ####### # # # # ############# ############### # ### # ########### #
#   # # #   # #   #     #   # #   # # #       #   # # #     #     # #       # # # #               #               # #   # #             #
# # # # # # # ### # # # # # ### ### ##### # # ### ##### # # ### ############# # # # # ############# ####### ######### ### ### ####### ###
# # # # # # #   # # # # # #   #   #     # # #   #     # # #   #             # # # # #             #       #         #   #   #       #   #
# ### # # # # # # # # # # ### ##### ### ### # # # ### # # # # ##### ####### ##### # ### # # # ############# # # # # # # # ####### # # # #
# #   # # # # # # # # # #   #   #     #   # # # #   # # # # #     #       #     # #   # # # #             # # # # # # # #       # # # # #
# # # ### ##### # # ##### # # ##### # # # ### # # ### ######### ### ### ########### # ### # # ### # # ##### ##### ########### # ####### #
# # #   #   #   # #     # # #     # # # #   # # #   #         #   #   #           # #   # # #   # # #     # #   #           # #       # #
# ### # # # # # # # ### # # # # # # # # # ####### ### # # # ######### # # # # # # # # ### # # # # ### # ##### ############# ########### #
# #   # # # # # # #   # # # # # # # # # #       # #   # # #   #     # # # # # # # # #   # # # # #   # #                   #           # #
# # # # # # ### ### # ### # ### ### # # # # ### # # # ### # # # ####### # # # # ### ####### ########### # # ############# ######### # # #
# # # # # #   # #   #   # # # #   # # # # #   # # # #   # # #         # # # # #   #       #         # # # #             #         # # # #
# # ### ### # # ### ### ### # # # # ### # # # # # # # # # # # ### ######### ####### ### ####### ### # # # ################# ##### # # # #
# #   #   # # # #     #   #   # # #   # # # # # # # # # # # #   #         #     #     #       #   #   # #                 #     # # # # #
# # ### # # ### # # # # # # # # # ##### # # ### # # ### ##### # # # ############### ####### # ### ##### # ### # ### # # # # # # ### ### #
# #   # # # #   # # # # # # # # #     # # #   # # #   # # # # # # # #   #       #         # #   #     # #   # #   # # # # # # #   #   # #
# # # ####### # # # ### ### ### # ##### # # # ### # # ### # # ### ### ### ### ##### # ### # # # # # ####### # # # # # # # # # # ####### #
# # #     #   # # #   #   #   # #     # # # #   # # #       #   #           #   #   #   # # # # # #       # # # # # # # # # # #       # #
# # # # ### # # # # # # # # ### # # ##### # # # ### # ####### # # ################# ### # # # # # ### ##### ### ##### # # # # # ### ### #
# # # #   # # # # # # # # #   # # #   #   # # #   # #       # # #               #     # # # # # #   #     #   #   #   # # # # #   #   # #
### # # ### # # # # # # # # # ##### ##### # # ##### # ### ### # # ######### # ##### ### # # ### # # # # ### ######### # # # #############
#   # # #   # # # # # # # # #     #   #   # #     # #   #   # # #         # #     #   # # #   # # # # #   #         # # # #             #
### ##### # # ### # ### # ### # # # # ##### # ####### ##### # ### ### # # # # # # ##### # # ### ### ##### # # # ##### ### # # ##### ### #
#     #   # #   # #   # # #   # # # # #     #       #     # # #     # # # # # # #     # # # # #   #     # # # #     #   # # #     #   # #
# # # ### # # # ### ### # ### ### ### # # # ### ##### # ### ##### # # ### ####### ### ####### ##### ######### # # ### ##### # ##### ### #
# # # #   # # #   #   # # #     #   # # # #   #     # #   #   #   # #   #       #   #       # #   #   #     # # #   #     # #     #   # #
# # ### # # # # # ##### # # # ### ### ### # ### # ### ##### ##### # # ### # # ### # # # ### # # ####### ##### # # ### # ####### ### # # #
# #   # # # # # #     # # # #   #   # #   # # # #   #     #   #   # #   # # #   # # # #   #                 # # # #   #       #   # # # #
# # # # # # ### # # # # # # # # # # # # ### # ### # # # ### ### # # # # # # # # ##### # ##### ####### ### # ########### # # ### ##### ###
# # # # # # #   # # # # # # # # # # # # #       # # # #   #   # # # # # # # # #     # #     #       #   # #         #   # #   #     #   #
# # ### # ### # # ##### # # # ### # # # # # # ### # ### # # ##### # # ##### # # ### ##### ### ### # # # # ####################### #######
# # #   # #   # #     # # # # # # # # # # # #   # #   # # #   #   # #     # # #   #     #   #   # # # # #                 # # # #       #
# # # # # # # # ### # # # # # # ### # ##### # ##### ############# # # # # # # # # # ### # # # # # ### ### ############### # # # #########
# # # # # # # #   # # # # # #     # # #     #     #         #   # # # # # # # # # #   # # # # # #   #   #   #       #   #               #
# # ### # # # # # # ### # ### ### # ##### # # ##### # ####### ### ### ### # ### # ##### # ##### # # ######### ####### ####### # ##### ###
# # # # # # # # # # #   # #     # # #     # #     # #           #   #   # #   # #     # #     # # #                         # #     # # #
# # # # # # # # # ##### ##### ##### # # # # ####### # ### ##### # # # ######### ### ##### ### ### # # # # # # # # ### ####### ######### #
# # #   # # # # #   # # #         # # # # #       # #   #     # # # #         #   #   #     #   # # # # # # # # #   #       #         # #
# # ### ### # # # # # # # # # # ####### # # ####### # # # ##### ### # # # ### ### # # ### # ### # # # ####### # # # # ### # ####### ### #
# # #   #   # # # # #   # # # #       # # #       # # # #     #   # # # #   #   # # #   # #   # # # #       # # # # #   # #       #   # #
# ### # ### # ### # ### ##### ### ##### ### ### # # # # ##### ### ### ######### # # ##### # # # ##### # # # ##### # # # # ############# #
# #   # #   #   # # #   #       #     # #     # # # # #     #   # # #         # # #     # # # #     # # # #     # # # # #               #
### ##### # # ### ### # ### # # ### # # # # ### ##### ############# ####### ##### # # # ### # ### ### # # # # ### # # # # # ### ### # ###
#   #     # #   #   # #   # # #   # # # # # #       #                     #     # # # #   # #   #   # # # # #   # # # # # #   #   # #   #
# ### # ### # ##### ### # # # # # ##### ### ### # # # ### ### ##### ########### ### # ####### ######### # ### ##### # # ### ##### #######
# #   # #   #     #   # # # # # #     # #     # # # #   #   #     #           #   # #       #       #   #   #     # # #   #     #       #
# # # ##### ### # # # # # # ### ########### ### # ### # # ##### ### ##### ### # ####### # ######### ### # ################# # ####### ###
# # # #       # # # # # # # #           #   #   #   # # #     #   #     #   # #       # #         #   # #         #       # #       #   #
# # # ##### # # ### ##### # # # # # ####### # # # ### ### # ######### # # ### ####### # ### # # ### ### # # # # ### ##### # # ### # ### #
# # # #     # # # # # #   # # # # #     #   # # #   #   # #         # # #   #       # #   # # #   #   # # # # #         # # #   # #   # #
##### ##### # ### ### # # # ### ### # ##### # # # # # ### ####### ### # # # ### # # ##### # ### # ####### # # # # # ### # # # ###########
#     #     #         # # # #   #   #     # # # # # #   #       #   # # # #   # # #     # # #   #       # # # # # #   # # # #           #
# # ### # # # # ### # ### ##### ### # # ### # # # ### # # ########### # # ######### ### ### # # ##### ### ##### # # # # # # # # # # # # #
# # #   # # # #   # #   # #     #   # #   # # # #   # # #           # # #         #   #   # # #     #   #     # # # # # # # # # # # # # #
####### ### ### ### # ### # # # ### # ##### ### # # ##### # # ### # ################### # # ### # # ####### ### # ######### # # # ##### #
#       #     #   # #   # # # #   # #     # #   # #   #   # #   # #                   # # # #   # #       #   # # #       # # # #     # #
# # # # ### # ####### # ##### # ### # ####### # # # # ### # # ### # # ### # # ####### # # # # # # # # # # # # # # # ### ### # ##### #####
# # # # #   #       # # #     # #   #   #     # # # #   # # #   # # #   # # #       # # # # # # # # # # # # # # #     #   # #     #     #
# # # # ### # # ####### ##### ### # # ### # # # # # ### # # # ##### # ####### # ### # # ### ### # # # # ##### # # # # ####### ##### ### #
# # # # #   # #       # #     #   # #   # # # # # #   # # # #     # #       # #   # # #   #   # # # # #     # # # # #       #     #   # #
# ##### # # # ### # # # ### # ### # # # ### # ### # ### # ### ##### ### ##### # # ######### # # # # # # ### ### # # # ##### # ### #######
# #   # # # #   # # # #   # # #   # # # #   #   # #   # # #       #   #     # # #         # # # # # # #   #   # # # #     # #   # #     #
##### # # ### # # # # # # # # ### ####### # # # # # ### # # # # # ### # ##### ### # ### ### ### # # # # # ######### # # # ### # ### ### #
#       # #   # # # # # # # # #         # # # # # #   # # # # # #   # #     #   # # # #   #   # # # # # #         # # # #   # #       # #
# # # # # ### # # # ### # # ### # # # ### # # # # # # # # # ### ### ##### # # # ### # ##### # # ### # ##### ####### ### ######### # #####
# # # # # #   # # #   # # # #   # # # #   # # # # # # # # # #     #     # # # #   #       # # #   # #     #       #   #         # #     #
####### ##### # # # ##### # # ### # ##### # # ### # # # # # ### ### ########### ##### # ### ### ### # # # # ####### ##### ### # # ##### #
#         #   # # #   # # # # #   #   #   # # # # # # # # # # # # #           #     # #   #   #   # # # # #   #   #     #   # # #     # #
##### # # # # ######### # ##### # ######### ### # # # ##### # # # ####### # # ### ############# ##### # # ##### ##### ### # # ###########
#     # # # #           #     # #     #         # # #     #   #         # # #   #             #     # # #           #   # # #          x#
#########################################################################################################################################
