#########################################################################################################################################
#o                                    #   #                 # # #         #       # # #     #                                       # # #
# ##### ####### ################### ### ### ### ############# # # ######### ####### # # ##### ############### ### ####### ### # # ### # #
#     #       #                   #           #   # # #       #                     #       #   # #     # # #   #       #   # # #       #
# # # ##### ##### # ################### ##### # ### # # ####### ##################### ####### ### # ##### # ################# # # #######
# # #     #     # #                   #     # #       # #   #   #     # #       #   # #       #                   #         # # #       #
# # # ####### ##### ##### # # ### # # ### # # # # ##### # ### ### ##### # ### ### ### # ####### ### ############### ################# # #
# # #       #     #     # # #   # # #   # # # # #   # #                     #                     #                                 # # #
# # # # # # ### ### ### # ### # # ### # # ########### # ##### # ########### # # # # ####### ### ##### # # ### ##### # # ### ####### # ###
# # # # # #   #   #   # #   # # # # # # #   # # # #   #     # # #         # # # # # #     #   #     # # #   #     # # #   #       # #   #
# # # # # # # ####### # # # # ##### # # ##### # # # ### ##### ### ########### ### # # ### # # ##### ### # # # ####### # # ########### ###
# # # # # # #       # # # # # #     # #                     #               #   # #     # # #     # #   # # #       # # #           #   #
# # # # # # # ####### ##### # # ##### ##### # # ##### # # ####### # ##### # ##### # # # ### # ##### ### # ####### # ### ### ### # # ### #
# # # # # # #       # #   # #       #     # # #     # # #       # #     # #     # # # #   # #     #   # #       # #   #   #   # # #   # #
# # # # ### # # # ##### ####### # ################# ### ######### # ### ####### ##### # # ####### ##### # ####### ##### # # # ###########
# # # #   # # # #             # #                 #   #         # #   #       #     # # #       #   #   #       #     # # # #     # #   #
# ##### ### ### # ### ##### # ######### # # # # ##### ##### ### ##### ### # ######### # ### # # ######### ######### ### # # ### # # # ###
#     #   #   # #   #     # #         # # # # #     #     #   #     #   # #         # #   # # #       # #         #   # # #   # #   # # #
# ##### ##### ### ####### ####### # # # ##### ### ### ### # # ############# ##### ### ########### ##### # ### ####### # # # ######### # #
#   # #     #   #       #       # # # #     #   #   #   # # #             #     #   #           #       #   # #     # # # # # #   # # # #
# # # # ### # ### ##### # ####### # ######### ########### ### # ### # ####### ##### # # # ####### ####### ##### ######### # # # ### # # #
# #   #   # # #       # #       # #         #           #   # #   # #       #     # # # #       # #     #           #   # # #     # #   #
# # ### ##### ### # # # # # # # # # ############### ######### ### # # # ##### # # ##### # # ####### ####### ### # ### ####### ##### # ###
# #   #     # #   # # # # # # # # #   #           #         #   # # # #     # # #     # # # #             #   # #                 #     #
# ### # # ### # # ### ##### # # # ### # ### # # ####### ############### # # ######### ### ### ########### ##### # # # # ### # ##### ### #
#   # # #   # # #   #     # # # #   #     # # #       #               # # #         #   #               #     # # # # #   # #         # #
# # # # # ### ### ####### ### # ### # # # # # # ### # # ##### # ### # ##### ### ############# # ##### # ####### ##### ########### #######
# # # # #   #   #       #   # #   # # # # # # #   # # #     # #   # #     #   #             # #     # #     # #     #           #       #
# ### # # # # ### # ### # # # # # ### ### # # # # # ### # # ##### ############# ### ##### # # # ### # # ##### ####### # ##### ###########
#   # # # # #   # #   # # # # # # #     # # # # # #   # # #     #             #   #     # # # #   # # #             # #     #           #
# ### # # # ##### # # # # ### ### # # ### # ##### # # # ####### ############# # ### ####### # # ##### # # ### # ##### ##### ### ### # ###
#   # # # #     # # # # #   #   # # #   # #     # # # #       #             # #   #       # # #     # # #   # # # # #     #   #   # # # #
# ### # ### # # # # ########### # ######### # ##### # ####### # # ### # ### ### ##### # # ##### # ### ### ####### # ##### ############# #
#   # # #   # # # #           # #         # #     # #       # # #   # #   #   #     # # #   #   #   #   #             # # # #   # #   # #
# ### ### # # # # # # ##### ### # ### ####### ##### ### # ### # ##### # # # ####### ########### ############# # ####### ### # ### # ### #
# #     # # # # # # #     #   # #   #     #       #   # #   # #   # # # # #       #           #             # #       # #               #
# ### ### # # # # # ####### # ### # # # ### # # # # # # # # ### # # # ########################### ########### # # ##### # ###############
#   #   # # # # # #       # #   # # # #   # # # # # # # # #   # #   #                   #       # # # #   # # # #                       #
# # ####### ### # # # # # # # ##### ### ##### # # # ####### ### # # ### # ####### ####### ##### ### # # ### ##### ### ### ####### ### # #
# #     #   #   # # # # # # #     # # #     # # # #       #   # # #   # #       #     # #     #                 #   #   #       #   # # #
# # # ### # # # # # # # # ### ####### # ### # ### ### # # # # ### # # ##### ######### # # ##### # # # ####### ##### ##### ##### # ##### #
# # #   # # # # # # # # #   #         #   # #   #   # # # # #   # # #     #       # #         # # # #       #     #     #     # #     # #
# # ### # # # ### # ##### # # ### ### ### # # # # # # # ### # # # # # # ### # ##### ### # ### ####### ### ### ##### ####### # # # ### # #
# #   # # # # # # #   #   # #   #   #   # # # # # # # #   # # # # # # #   # #         # #   #       #   #   #     #       # # # #   # # #
# # # # # ### # # ####### # # # ####### ### # # ### ### ####### # # # ### # # ########### ####### ### # # # # ####### ####### # # # ### #
# # # # # # #   #       # # # #       #   # # # # #   #       # # # #   # # #           #       #   # # # # #       #       # # # #   # #
# # # # # # # ### # # # ##### ### ### # ##### # # # ### # ##### # # # ### # # # ### # # # ### # # # # # ### # ##### # # ### # ### ##### #
# # # # # #     # # # #   #     #   # #     # #   #   # #     # # # #   # # # #   # # # #   # # # # # #   # #     # # #   # #   #     # #
# # # # ### # # # # # # # ### # # ### # ####### # # ##### ### ####### ####### # # ### ##### ##### ### # ### ### # ### ####### ### #######
# # # # #   # # # # # # # #   # #   # #       # # # #   #   #     #         # # # #       #     # # # #   #   # # #         #   #       #
# ### ######### ### # # # # # ######### ##### # # ### ### # # # # # # # # # # # ### # # # # # ##### ####### # ####### # ####### # # #####
# #           #   # # # # # #         #     # # #       # # # # # # # # # # # #   # # # # # #             # #       # #       # # #     #
# # # ##### ### ### # # # # # # # # # # # # ##### # ### # ##### ### ### # # # # ####### ### # # ### # ##### # # # # # # # ####### ### # #
# # #     #   #   # # # # # # # # # # # # #     # #   # #     #   #   # # # # #     # #   # # #   # #     # # # # # # # #       #   # # #
##### # # # # # # ### # # # # # # # # # # # # ##### ######### ##### # # # # # # # ### # # # # ##### ####### # ##### ### # # ### ### # ###
#     # # # # # #   # # # # # # # # # # # # #     #         #     # # # # # # # #     # # # #     #       # #   # #   # # #   #   # #   #
# ### # ### ##### ### ### # ### # # ####### # # # # ### # # # # # # ### ### # # ####### # # ### ### ##### ##### # ##### # # # # # # # # #
# #   #   #   # #   # #   #   # # #       # # # # #   # # # # # # #   #   # # #       # # #   #   #     #     #       # # # # # # # # # #
### # # # ##### ##### # # # # # ### ######### # ### # # # # # ####### ### # # # ##### # ### ### # # # ####### ### # ### # ### ### # # ###
#   # # #         # # # # # # #   #         # # #   # # # # #       #   # # # #     # #   # #   # # #       #   # #   # #   #   # # #   #
##### # ### ####### ##### # # # # ################# # # # ### ##### ##### # ### ### ### ### # # ##### # ### # ########### ### ##### #####
#     #   #     #       # # # # #               #   # # #   #     #     # # #     #   #   # # #   #   #   # #           #   #     #     #
# # # # # # # ### ####### # # # # ##### # # # ##### # ### ### ### ########### # # ##### ### # # # # # # # ####### # ####### # ### #######
# # # # # # #           # # # # #     # # # #   # # #   #   #   #           # # #     #   # # # # # # # #       # #       # # # #     # #
# # ### # # # # ### ### ### ### # ### # ### ##### # ### ### # ### ### # # ##### ### ### ### # # ### # ##### # ######### ### ### ####### #
# #   # # # # #   #   #   #   # #   # #   # #     #   #   # #   #   # # #     #   #   #   # # #   # #     # #         #   # #           #
### ### # # ### # ### # ### # # # # # ### # # ##### # ########### # ############# ### # # ### # # # # # # ### # # ########### ### ### # #
#     # # #   # #   # #   # # # # # #   # #       # #           # # #   #       #   # # #   # # # # # # #   # # #               #   # # #
### # # # ### # # # # # # # # # # # # # # # ### ### # # ########### # ### ######### # ### ### # ### # # # ### # # ##### # # ### # # # # #
#   # # #   # # # # # # # # # # # # # # # #   #   # # #           #               # #   # # # #   # # # #   # # #     # # #   # # # # # #
### # ### # # # # ##### ### # # ##### ##### # ############### # # # ####### ######### ##### ##### # ##### # ### # # ##### # # ### ### # #
# # #   # # # # #   #     # # #   #       # #               # # # #       #         # #         # #     # #   # # #     # # #   #   # # #
# ### # # # # # # ### # # ### # ### # # # # ##### # # # # # ####################### # # ### ### # ##### # ### # # ##### ### ##### # # # #
#     # # # # # # #   # #   # #   # # # # # #   # # # # # # #     # #           # # #     #   # #     # #   # # #     #   #     # # # # #
### # ### # # ### ### # # ##### # ### # ### # ### # ######### ##### # ##### ##### ####### ##### # ### ### ######### ############### #####
#   #   # # # #     # # #   #   #   # #   #     # #       #               #             #     # #   #   #   #     #     #         # # # #
# # ##### ##### # # # ### # ### # ### # # # ################# ####### # ##### # # ### ######### # ####### # # ### # ##### ########### # #
# #     #     # # # # #   #   # #   # # # #         # #             # #   # # # #   #       #   #       # #     # #           #         #
# # # ### # # # # # # ### # ### # # # # # # ######### # ######### ### ### # ##### # ##### # ####### ##### # ####### ### ####### #########
# # #   # # # # # # #   # #   # # # # # # #               #     #   #   #     # # #     # # # #   #     # #       # # #     #     # #   #
# # ##### ### # # # # ##### ### # ### ### # # ######### # # ####### ##### ##### ######### ### # ##################### ### ### ### # # ###
# #     #   # # # # #   #     # #   # #   # #         # #       # #     #           # # # #             #       #   # # #       #       #
# # # ### ### # ### # ### # ### # # ##### # # ### ####### # # ### ##### # ########### # ### ##### # # ### ####### ### # ####### #########
# # #   #   # # #   #   # #   # # # #     # #   #     # # # #         # # #   #                 # # #                         #         #
# ### # # # # # # # # # # # # ### # ### # # # # # ##### ####### ### ####### ### ### ### # ##### ### # # # ######### ######### # # ### ###
#   # # # # # # # # # # # # #   # #   # # # # # #             #   #               #   # #     #   # # # #         #         # # #   #   #
# # # ### ########### ##### # # # # ### ### # # # ####### ##### # # # ####### # # # # ### ### # # # # # # # # ##### # ##### ##### # ### #
# # #   # #       # #     # # # # #   # #   # # #   # # #     # # # #       # # # # #   #   # # # # # # # # #     # #     #     # #   # #
# # # # ### ####### # ##### # ##### ##### # ### ### # # ### ### ### # # ### # # # # # # ######### # # ##### ####### # # # ####### ### # #
# # # #         #         # #   #   #     #   #   #       #   #   # # #   # # # # # # #         # # #     #       # # # #       #   # # #
# # # # # ##### # # # # # # # ### # # # # # # # # # ### # ##### # ### # ### ### # # # ### ##### ##### # ### # ##### # # # # ####### # ###
# # # # #     # # # # # # # #   # # # # # # # # # #   # #     # #   # #   #   # # # #   #     #     # # #   #     # # # # #       # #   #
# ##### # # ### ### # # # # # ### # ### ### # ### # # # ### # ### ### # ##### # # # # # ### # ##### # ### # # ######### # # # # # # ### #
# #     # # # # # # # # # # #   # # #   #   # #   # # #   # #   # #   #     # # # # # #   # #     # #   # # #         # # # # # # #   # #
##### # # ### ### # ####### # # ##### # # # # ### # ### # ##### ##### ####### ######### ##### # ##### # ### ### ####### # ### ### # #####
#     # #         #       # # #   # # # # # # #   #   # #     # #   #       # # #   # #     # #     # #   #   #       # #   #   # #     #
# # # # ### ### ### # ##### # ##### ### ### ### # # ### # ####### ### # # # ### # ### ##### ### ##### ##### # # # # ### ### # ### #######
# # # #   #   #   # #   #   #       #     # #   # #   # #           # # # #               #   #   # #     # # # # #   #   # #   #       #
# # # # # ### # # # # # ##### ####### # ### ### # # # # # # ### # # # # ####### # # # ##### # # # # ### # ### # # # ### # # # ### # ### #
# # # # #   # # # # # # #   #       # #   #   # # # # # # #   # # # # #       # # # #     # # # #     # #   # # # #   # # # #   # #   # #
# # # # # # # # # # # # ### # ####### # ### ### ### ### ####### ### # # ### ### # # # # ### ######### ### ### ##### # # # # # # # ### ###
# # # # # # # # # # # # #           # #   # #     # #         #   # # #   #   # # # # #   #   # # # #   # # #     # # # # # # # #   #   #
# # # # # # # # # # # # # # # ####### # # # # # # # ### # # ########### # # # ################# # # ####### ################# ##### ### #
# # # # # # # # # # # # # # #       # # # # # # # # #   # #           # # # #                                   #           #     #   # #
### # # ### ######### # ##### ### # # ### ### # # ### # # ####### # # # # # ##### ### ### ### # ############# ### ######### # ##### # # #
#   # #   #   # #   # # #       # # #   #   # # #   # # #       # # # # # #     #   #   #   # #             #             # #     # # # #
# # # # # # # # # ### # ##### # # ##### # ### ### ##### # ####### ### ### ### ### ### # ### ### # ####### ### # ### ####### ### #########
# # # # # # #       # # #     # #     # # #   #       # #       # # # #     #   #   # #   #   # #       #   # #   #       #   #         #
# # ### # ### # # ####### # # # # ##### ### # # # # ##### # ### # # ### # ####### ##### ### ### ####### # ### ### # # # # ########### ###
# # #   # # # # #       # # # # #     #   # # # # # # #   #   # #     # #       #     #   #   #       # #   #   # # # # #           #   #
# ##### # # # # ##### # ### # ### # ######### ##### # # # # # # # # # ### ### ##### # # # # # # # # ##### # # # # # ### # ##### # ### ###
# #     #   # #     # # #   #   # #     #   #     #   # # # # # # # #   #   #     # # # # # # # # #   #   # # # # #   # #     # # # #   #
# ### # # # # # # ######### # ### ######### # ##### ### # # # # # ####### # # # ### ##### # ### # # ##### ### # ##### # # ######### # ###
#   # # # # # # #         # # #         #       #     # # # # # #       # # # #   #   # # # #   # #     #   # #     # # #         # #   #
# # # # ### # ########### # # # # ### ####### ##### ### # ### # ####### # ##### ### ### ### # # # ### ### # # # # ### ### ### ##### ### #
# # # # #   #           # # # # #   #       #   #     # # #   #       # #     #   #       # # # #   # #   # # # #   #   #   # #       # #
# # # # # # # # ##### ##### # ### ######### # ### # # ### ### # ### ######### # ### ########### # # ### # ### # # ### # # # ### ##### # #
# # # # # # # #     #     # # #           # # #   # # # #   # #   #         # #   #         #   # #   # # #   # #   # # # #         # # #
# ##### # # # # # # # # ##### # # ### # ### # ### # # # # # # # # # # # ### # # ### # ##### # # # ##### # ##### # ####### # # # # # #####
#     # # # # # # # # #     # # #   # #   # #   # # #   # # # # # # # #   # # #   # #     # # # #     # #   # # #       # # # # # #     #
# # ### # # # # ### # # # ##### # # # # # # # # # ### # ##### # # # # # ### # # # ########### # # # ##### # # # # ####### # # # # #######
# #   # # # # #   # # # #     # # # # # # # # # #   # #   #   # # # # #   # # # #           # # # #     # #   # #       # # # # #       #
# # # ##### # # ### # ### # # # # # # # # # # ### ### # ##### ### # # # ### # ### ######### ##### ####### ############# # # # # # #######
# # #     # # # # # # #   # # # # # # # # # # #     # # #       # # # # # # #   #         #     #     #               # # # # # #       #
# # # # ### # # # # # # # ### ### # # # ##### ### ### ### # # # # # # # # # ##### # # # # # ##### ####### ### # # ####### ##### ####### #
# # # #   # # # #   # # # #   #   # # #     # #     #   # # # # # # # #   #     # # # # # #   #       # #   # # #       #     #       # #
# # # # ### ### # # # ### ### # # # ### ##### ### # # # ### # # # # # ##### # ### # # ##### ### # # # # # # ### # ########### ### ### ###
# # # #   #   # # # # #     # # # # #       #   # # # # #   # # # # #     # #   # # #     #   # # # #   # #   # #           #   #   #   #
### ### # # # ##### # ### ### # # ##### # # # ### ### # ### # ### # ### # ### ### ### ### # ### # # ### ### # # # # # ###################
#     # # # # # #   #   # #   # #     # # # #   #   # #   # #   # #   # #   #   #   #   # #   # # #   #   # # # # # #       #   # #     #
# # # # ####### ### # ######### # # # # # # ### # # ### ##### ### # ####### # # # # # ### # ### ### # ####### # # # ### # ### ### # #####
# # # #           # #   #       # # # # # #   # # #   #     #   # #       # # # # # #   # #   # #   #       # # # #   # #   #       #   #
# # ### # ####### # # # # # # ### ##### # # # # # # # # # # # # ### ### ##### # ### # ### # ##### # # ######### ### ### ##### ####### ###
# # #   #   #   # # # # # # # #       # # # # # # # # # # # # # #     #     # #   # #   # #   # # # #   # #   #   #   #   #     #   # # #
# # ### ### # ######### # ####### # ### # # # ### ##### ############# # ##### # ### # # ### ### ### ##### # ########### ### ##### ### # #
# #   #   #         #   # #       #   # # # # #       #             # #     # #   # # #   #     #                     #                x#
#########################################################################################################################################
